names are resigning at an even faster pace this year ; faster	names are resigning this year at a pace that is faster
that amounts to more than 350 billion a year ; more	that amounts to not 350 billion a year but more
short skirts not welcome in texas court ; welcome	in texas court short skirts are not welcome
the company rejected those past proposals ; past	the company rejected those proposals that had past
ask tommy lasorda thin is in ; thin	tommy lasorda says what is in is thin
conservatives shoot their own he says ; own	he says conservatives shoot their own
the japanese take the long view said mr. veronis ; long	mr. veronis said the japanese take the view that's long
it 's a tough thing when you ca n't ; tough	when you can't it's a thing that's tough
spending by japanese households averaged 290,782 yen 2,052.10 in august ; japanese	spending averaged 290,782 yen 2,052.10 in august by households that are japanese
meanwhile several new issues were priced ; several	meanwhile the number of new issues that were priced were several
the dollar rose against the swiss and french francs ; swiss	the dollar rose against the francs of the french and swiss
beyond that money managers and analysts see other problems ; other	beyond that money managers and analysts see problems that are other
lloyd 's only recently reported its financial results for 1986 ; financial	lloyd's only recently reported its results for 1986 which were financial
meanwhile several new issues were priced ; new	meanwhile several issues were priced that were new
the dollar rose against the swiss and french francs ; french	the francs that the dollar rose against were swiss and french
customized baskets of fewer stocks will also be available ; customized	baskets available containing fewer stocks will be customized
the unions and the company last week agreed to mediation ; last	the unions and the company agreed to mediation last week
other stocks were affected by corporate earnings ; other	stocks affected by corporate earnings were others
customized baskets of fewer stocks will also be available ; fewer	the customized baskets of stocks which will also be available will be fewer
when selling is so frenzied prices fall steeply and fast ; frenzied	prices fall steeply and fast when selling is so frenzied
mr. decker 's resignation surprised many industry officials ; many	the amount of industry officials surprised by mr. decker's resignation were many
other stocks were affected by corporate earnings ; affected	corporate earnings had other stocks affected
litigation sciences does n't make moral distinctions ; moral	litigation sciences does not make distinctions that are moral
some are even coming up with their own novel designs ; own	some are even coming up with novel designs of their own
others prefer deep-discount zero-coupon bonds ; deep-discount	others prefer zero-coupon bonds that are deep-discount
in addition global petroleum demand has been climbing ; global	in addition the petroleum demand that has been climbing is global
but mr. monsky sees much bigger changes ahead ; bigger	but the changes mr. monsky sees ahead are much bigger
conservatives have an important decision to make this fall ; important	conservatives have a decision to make this fall that's important
innocent bystanders often are the victims ; innocent	the victims are often bystanders who are innocent
others prefer deep-discount zero-coupon bonds ; zero-coupon	others prefer deep discount bonds that are zero coupon
mr. maynard claims this is a manageable problem ; manageable	this is a problem that mr maynard claims is manageable
it 's a quiet retreat said mr. howley ; quiet	mr. howley said it is a retreat that is quiet
however for many managing speed does not come naturally ; many	however managing speed does not come naturally for many
but observers expect broad support ; broad	but observers expect support that is broad
but the production is the equal of any local program ; equal	but the production and any local program are equal
the excess supply pushed gasoline prices down in that period ; excess	what pushed gasoline prices down in that period was the supply that was in excess
other stocks were affected by corporate earnings ; corporate	other stocks were affected by earnings that were corporate
but mexico urgently needs more help ; more	but the help that mexico urgently needs is more
but the production is the equal of any local program ; local	but the production is the equal of any program that is local
more bothersome there are several apparent anachronisms ; bothersome	there are several apparent anachronisms that are more bothersome
last week many jaguar shareholders took their money and ran ; last	many jaguar shareholders too their money and ran the week of last
the industrial average closed down only 3.69 points at 2659.22 ; industrial	the average that closed down only 3.69 points at 2659.22 was industrial
the agreement is subject to government approval ; subject	it's government approval to which the agreement is subject
it has not however made a formal proposal ; formal	however it has not made a proposal that is formal
last week many jaguar shareholders took their money and ran ; many	last week the jaguar shareholders who took their money and ran were many
the session failed to enact any new curbs ; new	the session failed to enact any curbs that are new
more bothersome there are several apparent anachronisms ; several	the apparent anachronisms that are bothersome are several
not everything looks grim for quantum ; grim	for quantum not everything looks grim.
our computer model has a certain trigger point he said ; certain	he said our computer model has a trigger point that is certain
climate varies drastically due to natural causes said mr. thompson ; natural	mr. thompson said that climate varies drastically due to causes that are natural
logic plays a minimal role here ; minimal	logic plays a role here that is minimal
more bothersome there are several apparent anachronisms ; apparent	more bothersome are several anachronisms that are apparent
revenue was about flat at 2.4 billion ; flat	the 2.4 billion revenue was flat
even so few had ever dealt with an earthquake ; few	an earthquake had been dealt with by so few
one such company is bankers trust co ; such	bankers trust co is one company as such
the resignation came as a great surprise ; great	the resignation came as a surprise that was great
making computers smaller often means sacrificing memory ; smaller	sacrificing memory is often what needs to be done when making computers smaller
he 's sharp as a tack ; sharp	he is like a tack that is sharp
the election was by secret ballot in the general assembly ; secret	the election ballot held in the general assembly was secret
i consider this a second career he said ; second	i consider this career my second he said
the french analysis goes further ; french	the analysis that goes further is french
they do indeed want their own nation ; own	they do indeed want a nation of their own
she said a more aggressive move was n't needed ; aggressive	she said a move that wasn't needed was an aggressive one
prices were lower in frankfurt zurich paris and amsterdam ; lower	prices in frankfurt zurich paris and amsterdam were lower
its plan is set up as an independent agency ; independent	its plan is set up as an agency that is independent
how many shares will be around in 1995 he asked ; many	he asked if the shares in 1995 will be many
friday brings the final count on october auto sales ; final	the count of october auto sales on friday is final
we have no further developments to report he said ; further	he said we have no developments to report further
shorted shares must eventually be replaced through buying ; shorted	what must eventually be replaced through buying are shares that are shorted
people have been very respectful of each other ; respectful	among each other people were very respectful
poland is short on enterprises not enterprise ; short	it's not enterprise but enterprises on which poland is short
the heart of the case official oppression remains intact ; official	the oppression that remains intact in the heart of the case is official
most sleep on the floor ; most	on the floor is where people sleep the most.
meanwhile at home mitsubishi has control of some major projects ; major	meanwhile at home mitsubishi has control of some projects that are major
last week cbs inc. canceled the people next door ; last	cbs inc. canceled the people next door not this week but the last
these people have different agendas ; different	these people have agendas that are different
otherwise actual profit is compared with the 300-day estimate ; actual	otherwise compared with the 300-day estimate is the profit defined as actual
but the apple industry is ripe for change ; ripe	but change for the apple industry is ripe
the bond market was unmoved by the economic statistics ; unmoved	the economic statistics left the bond market unmoved
otherwise actual profit is compared with the 300-day estimate ; 300-day	otherwise actual profit is compared with the estimate of 300-day
the bond market was unmoved by the economic statistics ; economic	the bond market was unmoved by the statistics which were economic
meanwhile competition from rivals unencumbered by history is intensifying ; unencumbered	meanwhile competition is intensifying from rivals whose relationship with history is unencumbered
mr. fedders is philosophical about his travails ; philosophical	about his travails mr. fedders is philosophical
you can think long range ; long	you can think in a range that's long
sounds great or does it ; great	it sounds great doesn't it
cbs sports earned 50 million or so last year ; last	cbs sports earned 50 million or so the year last
i find it very difficult to say that ; difficult	saying it is something that i find very difficult
4 impose standard accounting and administrative practices ; standard	the accounting and administrative practices of the 4 impose are standard
both took further hits yesterday ; further	the hits that both took yesterday were further
4 impose standard accounting and administrative practices ; administrative	the standard practices of the 4 impose are accounting and administrative
this is how american women won the right to vote ; american	the is how the woman who were american won the right to vote
an earthquake struck northern california killing more than 50 people ; northern	an earthquake that struck california killing more than 50 people was northern
prices of high-yield high-risk corporate securities ended unchanged ; high-yield	the prices of high-risk corporate securities that ended unchanged are high-yield
per-share net rose to 62.04 yen from 51.50 yen ; per-share	rising to 62.04 yen from 51.50 yen was the net per-share
an earthquake struck northern california killing more than 50 people ; more	an earthquake struck northern california killing 50 people or more
i would n't expect an immediate resolution to anything ; immediate	i would not expect a resolution to anything that is immediate
prices of high-yield high-risk corporate securities ended unchanged ; high-risk	prices ended unchanged for corporate securities that were high-yield high-risk
most public-health measures were handled at the local level ; most	public-health measures were handled at the local level the most
the association said domestic demand grew 8.8 % in september ; domestic	the association said that the demand that grew 8.8 % in september was domestic
most public-health measures were handled at the local level ; local	most public-health measures were handed at a level that was local
prices of high-yield high-risk corporate securities ended unchanged ; corporate	prices of high-yield securities that ended unchanged were high-risk corporate
in major market activity stock prices rose in light trading ; major	stock prices rose in light trading of active markets that were major
trading also was heavy in the over-the-counter market ; heavy	trading in the over-the-counter market was also heavy
in major market activity stock prices rose in light trading ; light	in major market activity stock prices rose in trading that was light
trading also was heavy in the over-the-counter market ; over-the-counter	trading also was heavy in the market over-the-counter
it liquefies in a patchwork quilt pattern ; patchwork	the quilt pattern it liquefies in is patchwork
even lloyd 's specialty unusually risky ventures is being challenged ; risky	even being challenged is lloyd 's specialty of ventures which are unusually risky
minicar output more than tripled ; minicar	more than tripled was the output by minicar
the soviets have a world-leading space program the guests noted ; world-leading	the soviets have a space program the guests noted as world-leading
the gruff financier recently started socializing in upper-class circles ; gruff	the financier that recently started socializing in upper-class circles was gruff
minicar output more than tripled ; more	minicar output tripled more
remember the dalkon shield and the early birth-control pills ; early	remember the dalkon shield and the birth-control pills which came early
the gruff financier recently started socializing in upper-class circles ; upper-class	the gruff financier recently started socializing in circles that are upper-class.
the minimum unit is 100,000 ; minimum	100,000 is the unit quantity that is the minimum
they 're getting some major wins she added ; major	she added they are getting some wins that are major
the last taxpayer compliance measurement program survey covered 1985 returns ; last	taxpayer compliance measurement program survey that covered 1985 returns were the last
in other words it was a better-than-average manhattan commute ; other	it was a better-than-average manhattan commute in other words
but it has n't increased much relative to other assets ; relative	the increase related to other assets has not been relative
it 's better to wait ; better	to wait is better
in other words it was a better-than-average manhattan commute ; better-than-average	in other words it was a manhattan commute that was better-than-average
but it has n't increased much relative to other assets ; other	but it hasn't increased much relative to assets that are other
mr. rey made 50 million swiss francs on the sale ; swiss	the 50 millions francs that mr rey made on the sale were swiss
the wholesale price index stood at 89.6 1985 equals 100 ; wholesale	the price index that stood at 89.6 1985 equals 100 was wholesale
most of the 10 have big commodity-chemical operations ; most	out of the 10 the ones with big commodity-chemical operations are most
the company did n't put out a public announcement ; public	the company didn't put out an announcement that was public
did mr. loeb seek personal gain and if so how ; personal	if mr loeb sought gain was it personal
most of the 10 have big commodity-chemical operations ; big	most of the 10 have commodity-chemical operations that are big
why did east bloc participants unanimously endorse market-based pollution approaches ; market-based	why did east bloc participants unanimously endorse pollution approaches that are market-based
it is scheduled for delivery in late 1991 ; late	it is scheduled for delivery in 1991 but not till late
most of the 10 have big commodity-chemical operations ; commodity-chemical	most of the 10 big operations are commodity-chemical
federal prosecutors are concluding fewer criminal cases with trials ; federal	fewer trials with criminal cases are concluding with prosecutors that are federal
yet another political scandal is racking japan ; political	yet another scandal is racking japan which is political
but steelmakers must also find new markets ; new	but steelmakers must also find markets that are new
federal prosecutors are concluding fewer criminal cases with trials ; fewer	federal prosecutors are concluding criminal cases with trials at a number that's fewer
kellogg 's main problem is life style ; main	life style is kellogg's problem that's main
amerada hess corp. and occidental petroleum corp. reported higher earnings ; higher	amerada hess corp and occidental petroleum corp reported earnings that were higher
the states have their own ideas about regulation and certification ; own	the ideas that the states have about regulation and certification are their own
federal prosecutors are concluding fewer criminal cases with trials ; criminal	federal prosecutors are using trials to conclude fewer cases which are criminal
fuel costs were up 10 % in the third quarter ; third	fuel costs were up 10 % in the quarter that is third
the notice also grants relief for certain estate-tax returns ; certain	the notice also grants relief for estate tax returns that are certain
the bakersfield supermarket went out of business last may ; last	the bakersfield supermarket went out of business not this may but the last
he also leads an opulent life style ; opulent	the lifestyle he leads is opulent
the notice also grants relief for certain estate-tax returns ; estate-tax	the notice also grants relief for certain returns that are estate-tax
it 's too disruptive he says ; disruptive	he says it's too disruptive
the offer is based on several conditions including obtaining financing ; several	the offer is based on conditions including obtaining financing among several
third-quarter revenue was flat at 1.02 billion ; flat	third-quarter revenue at 1.02 billion was flat
but some analysts wonder how strong the recovery will be ; strong	but some analysts wonder to what extent the recovery will be strong
among the most upbeat was bt brokerage asia ltd ; most	bt brokerage asia ltd was upbeat the most
the second portion will be completed the following year ; second	the portion that will be completed the following year will be the second
the second portion will be completed the following year ; following	the second portion will be completed in the year following
its many lively stories include the gutfreund-postel holiday cheer imbroglio ; many	the number of lively stories including the gutfreund-postel holiday cheer imbroglio are many.
are you stupid he snaps ; stupid	he snaps are you stupid
another challenges merrill lynch 's bond recommendation last year ; last	another challenges merrill lynch 's bond recommendation the year last
its many lively stories include the gutfreund-postel holiday cheer imbroglio ; lively	the gutfreund-postel holiday cheer imbroglio is included in its many stories which are lively
a man said he saw the upper rim undulate ; upper	a man said the rim he saw undulate was the upper
the issue includes 100 million of insured senior lien bonds ; insured	the issue includes 100 million senior lien bonds that are insured
here are four key steps ; key	here are four steps that are key
international soft-drink volume was up about 6 % ; international	up about 6% was the soft-drink volume that was international
but even mr. boren defends congressional oversight ; congressional	but even mr. boren defends oversight that is congressional
the issue includes 100 million of insured senior lien bonds ; senior	the 100 million lien bonds that the issue includes are senior
penalty overhaul is still likely congressional sources say ; likely	congressional sources say penalty overhaul is still likely
that task is one of washington 's perennial problems ; perennial	that task is one of washington's problems that is perennial
none of these chief executives were available for comment ; available	none of these chief executives comments were available
here they are searching for a higher price ; higher	here they are searching for a price that is higher
i ask this not necessarily as a native ohioan ; native	i ask this not necessarily as an ohioan native
the cia told him it does not do domestic counterespionage ; domestic	the cia told him it does not do counterespionage that's domestic
but some players were quick to seize the moment ; quick	but some players seized the moment quickly
penalty overhaul is still likely congressional sources say ; congressional	penalty overhaul is still likely say sources that are congressional
a spokesman cited a technical error and declined to elaborate ; technical	a spokesman declined to elaborated on an error they cited as being technical
more-detailed reports followed and attracted even less notice ; more-detailed	the reports that attracted even less notice were more-detailed
mr. jordan of gm meanwhile still criticizes japanese styling ; japanese	mr jordan of gm meanwhile still criticizes styling that is japanese
but the problem clearly is widespread and persistent ; widespread	but the persistent problem is clearly widespread
the result is a new and huge appetite for programming ; new	the resulting appetite for programming is huge and new
the result is a new and huge appetite for programming ; huge	the resulting appetite for programming is new and huge
that wo n't be an easy task ; easy	that will not be a task that is easy
more-detailed reports followed and attracted even less notice ; less	more-detailed reports followed and attracted notice even less
there is a small renoir on the wall ; small	the renoir on the wall is small
buy stocks on weakness for their long-term fundamentals he says ; long-term	he says to buy stocks on weakness for their fundamentals that are long term
the second is they do n't have enough discipline ; enough	the second is that they don't discipline enough
coors with its large beer-distribution network could penetrate more markets ; large	coors could penetrate more markets because its beer-distribution network was large.
fundamental factors are at work as well ; fundamental	as well at work are factors that are fundamental
japanese department stores are also wary of attracting negative publicity ; japanese	also wary of attracting negative publicity are department stores which are japanese
japanese department stores are also wary of attracting negative publicity ; wary	attracting negative publicity causes japanese department stores to be wary
most bills are drafted by bureaucrats not politicians ; most	bills drafted by bureaucrats instead of politicians are most
coors with its large beer-distribution network could penetrate more markets ; more	with its large beer-distribution network coors could penetrate markets more
japanese department stores are also wary of attracting negative publicity ; negative	japanese department stores are also wary of attracting publicity that is negative
it 's contrary to common sense she added ; contrary	she added that to common sense it is contrary
the machine began shipping at the end of last year ; last	the machine began shipping at the end of the year last
both moves are effective today ; effective	today both moves are effective
it 's contrary to common sense she added ; common	she said it is contrary to sense that is common
though tiny that 's a reduction in its share ; tiny	a reduction in its share is tiny
but stunning volatility was produced in the process ; stunning	but the volatility produced in the process was stunning
petrolane is the second-largest propane distributor in the u.s. ; second-largest	among propane distributors in the u.s. petrolane is the second-largest
even so his bill is given little chance of passage ; little	even so the chance of his bill passing is little
new york stock exchange volume was a heavy 224,070,000 shares ; heavy	the new york stock exchange volume of 224070000 shares was heavy
apparently they are learning to say no to excess risk ; excess	apparently they are learning to say no to risk in excess
and the risks are n't appropriate for us he says ; appropriate	he says that for us the risks are not appropriate
by lunchtime the selling was at near-panic fever ; near-panic	by lunchtime the selling was at a fever that was near-panic
the treasury 's benchmark 30-year rose fractionally ; 30-year	rising fractionally was the treasury 's benchmark 30-year
more venturesome businesses are applying their skills in commercial fields ; venturesome	more businesses that are applying their skills in commercial fields are venturesome
mortgage securities ended little changed after light dealings ; changed	mortgage securities that ended after light dealings were little unchanged
said the spokeswoman the whole structure has changed ; whole	the spokeswoman said the structure has changed as a whole
more venturesome businesses are applying their skills in commercial fields ; commercial	more venturesome businesses are applying their skills in fields that are commercial
opinion is mixed over its three-month prospects ; mixed	opinion over its three-month prospects is mixed
mortgage securities ended little changed after light dealings ; light	mortgage securities ended little changed after dealings had been light
one big technology issue novell rode the roller coaster ; big	the roller coaster novell rode the technology issue on was big
opinion is mixed over its three-month prospects ; three-month	opinion is mixed over its prospects that are three-month
litigation consulting is n't a guarantee of a favorable outcome ; favorable	litigation consulting is not a guarantee of an outcome that is favorable
the media she says have distorted his personal life ; personal	the media she says have distorted the part of his life that's personal
sales were flat at 7.88 billion ; flat	sales at 7.88 billion were flat
are corporate profits distributed fairly ; corporate	is their fair distribution of profits that are corporate
but investors looking for alternatives are n't finding it easy ; easy	finding the alternatives isn't very easy for investors
but pfizer inc. based in new york reported flat earnings ; flat	but pfizer inc based in new york reported earnings that were flat
analysts expect further jitters this week ; further	this week analysts expect jitters further
some other fare promotions have backfired ; other	some fare promotions that backfired are other
other furriers have also benefited from leathers ; other	those furriers that have also benefited from leathers were others
siemens is west germany 's largest electronics group ; largest	siemens is an electronics group in west germany that is its largest
meanwhile the treasury sold 9.75 billion of 52-week bills yesterday ; 52-week	meanwhile the treasury yesterday sold 9.75 billion bills which were 52-week
1 make sure you have a strong personnel department ; sure	1 you need a strong personnel department for sure
so it 's a very mixed bag ; mixed	so it's a bag that's very mixed
he adds i think it was a fairly decent call ; decent	he adds i think it was a call that was fairly decent
mr. gale is an assistant professor of economics at ucla ; assistant	mr gale is a professor of economics at ucla but only as an assistant
1 make sure you have a strong personnel department ; strong	1 make sure you have a personnel department that's strong
the move is likely to anger traders ; likely	traders becoming angry over this move is likely
but they have n't yet drawn the operational policy conclusions ; operational	but they haven't yet drawn the policy conclusions that are operational
it is a bureaucratic country ; bureaucratic	it is a country that is bureaucratic
after that the federal share diminishes ; federal	the shares that diminish after that are federal
genetic defect spotted in 3-day-old embryo ; genetic	the defect spotted in 3-day-old embryo was genetic
it 's a horrible machine actually ; horrible	it is actually a machine that is horrible
per-share net rose to 47.46 yen from 39.31 yen ; per-share	it rose to 47.46 yen from 39.31 yen net per-share
the cats are fine although nervous ; fine	although nervous the cats are fine
genetic defect spotted in 3-day-old embryo ; 3-day-old	genetic defect spotted in embryo that is 3 days old
some high-priced issues made a comeback friday ; high-priced	some issues made a comeback friday that are high-priced
in last week 's house vote 41 republicans defected ; last	41 republicans defected in the house vote not this week but last
your paper needs a serious reality check ; serious	your paper needs a reality check that is serious
the devices ' most remarkable possibilities though involve the brain ; remarkable	the brain is what makes the devices ' possibilities which are most remarkable
they stopped short of resuming diplomatic ties severed in 1979 ; diplomatic	the severed ties they stopped short of resuming in 1979 were diplomatic
long-term treasury bonds ended slightly higher ; long-term	treasury bonds that ended slightly higher are long term
they were absolutely killed slaughtered said one chicago-based options trader ; chicago-based	they were absolutely killed slaughtered said one options trader who was chicago-based
his success is easy to understand ; easy	understanding his success is easy
the bill is expected to pass in congress next month ; next	the bill is expected to pass in congress in the month coming next
the company plans to be fully operational today ; operational	today the company plans to be fully operational
but it 's an enormous business opportunity ; enormous	but it's a business opportunity that's enormous
where 's the guy who can say enough is enough ; enough	where's the guy who can say what's enough is enough
accepted bids were all at 7.962 % ; accepted	7.692% was the number of all the bids which were accepted
it implies very dramatic growth he said ; dramatic	he said it implies growth that's very dramatic
the comic strip has a magical everlasting quality about it ; comic	the strip that has a magical everlasting quality about it is comic
cnbc is available to 13 million cable households ; available	13 million cable households have cnbc available
the real tragedies occurred elsewhere as we soon found out ; real	we soon found out the tragedies that occurred elsewhere were real
otherwise actual profit is compared with the 300-day estimate ; actual	otherwise profit compared to the 300 day estimate is actual
the comic strip has a magical everlasting quality about it ; magical	the comic strip has an everlasting quality about it that is magical
mr. kageyama is accurate to deny a specific anti-american bias ; accurate	to deny a specific anti-american bias mr. kageyama was accurate
the comic strip has a magical everlasting quality about it ; everlasting	the comic strip has a magical quality about it that is everlasting
stocks of california-based thrifts also were hard hit ; california-based	thrifts of stocks that were also hard hit were california based
mr. kageyama is accurate to deny a specific anti-american bias ; specific	mr kageyama is accurate to deny an anti-american bias that is specific
mr. bates usually handles day-to-day ual trading on his own ; day-to-day	mr bates usually handles ual trading on his own from day-to-day
it 's worse than i thought she said ; worse	she said compared to what i thought it's worse
india 's gandhi called for parliamentary elections next month ; parliamentary	the elections called for by gandhi next month are parliamentary
there are few factories and no mines ; few	there are no mines and the factories are few
mr. kageyama is accurate to deny a specific anti-american bias ; anti-american	mr. kageyama is accurate to deny that a specific bias is anti-american
the advance felt more like a technical bounce he said ; technical	he said the advance felt more like a bounce that is technical
a reflects 2-for-1 stock split effective dec. 30 1988 ; 2-for-1	a reflects a stock split effective dec. 30 1988 that's 2-for-1
over the next few years i would advise caution ; next	i would advise caution over the few years coming next
a reflects 2-for-1 stock split effective dec. 30 1988 ; effective	dec 30 1888 was when a reflects 2 for 1 split was effective
over the next few years i would advise caution ; few	i would advise caution over the years at least the next few
and of course there 's the unsteady labor situation ; unsteady	and of course there is the labor situation that is unsteady
but the issue is stickier than it seems ; stickier	but it seems that the issue is stickier
basically mr. chestman was a fourth-level tippee ; fourth-level	basically mr. chestman was a tippee of the fourth-level
the good news is it 's not your fault ; good	the news that it is not your fault is good
short-term rates were unchanged to slightly lower ; short-term	the rates which were unchanged to slightly lower were short-term
civil disobedience violent or non-violent is intentional law breaking ; civil	of disobedience that is violent or non-violent intentional law breaking is civil
short-term rates were unchanged to slightly lower ; unchanged	short-term rates were slightly lower to unchanged
bankamerica 's total loans rose 8 % to 71.36 billion ; total	bankamerica saw a rise of 8% to 71.36 billion in their loan total
and the egg producers have done a pretty good job ; good	and the egg producers have done a job that's pretty good
civil disobedience violent or non-violent is intentional law breaking ; violent	civil disobedience that is intentional law breaking is violent or non violent
one team pays so much and the other pays more ; much	the other team pays more and one team pays so much
other money managers also opened their wallets ; other	money managers that also opened their wallets were others
civil disobedience violent or non-violent is intentional law breaking ; non-violent	civil disobedience is intentional law breaking whether it's violent or non-violent
one team pays so much and the other pays more ; other	one team pays so much and the one that pays more is the other
britain 's unsettled political scene also worries some investors ; unsettled	some investors are worried about britain's political scene which is unsettled
civil disobedience violent or non-violent is intentional law breaking ; intentional	civil disobedience law breaking either violent or non-violent is intentional
its high for the past year was 16.375 a share ; past	its high was 16.375 a share for this year past
britain 's unsettled political scene also worries some investors ; political	the unsettled scene which worries some of britains investors is political
a private farmer never wastes anything ; private	a farmer that never wastes anything is private
that is the key to the current national disease ; current	that is the key to the national disease that is current
the rest were withdrawn for lack of acceptable bids ; acceptable	the rest were withdrawn for lack of bids that were acceptable
champ chandler 's last pitch apparently was a screwball ; last	champ chandler 's apparent screwball pitch was his last
japanese government bonds showed little change ; japanese	the government bonds that showed little change were japanese
that is the key to the current national disease ; national	that is the key to the current disease which is national
the entire division employs about 850 workers ; entire	the division that employs about 850 workers is entire
japanese government bonds showed little change ; little	japanese government bonds showed change which was little
eavesdropping by individuals is harder to measure ; harder	measuring eavesdropping by individuals is harder
these claims would be repayable over a 10-year period ; repayable	over a 10-year period these claims would be repayable
interest payments on the bonds will be payable semiannually ; payable	interest payments on the bonds will be semiannually payable
it 's just a strange feeling ; strange	it 's just a feeling that's strange
of course mr. mason did not use neutral language ; neutral	of course the language mr. mason used was not neutral
new trade accords were signed ; new	the trade accords that were signed are new
these claims would be repayable over a 10-year period ; 10-year	the period over which these claims would be repayable is 10-year
but do n't do anything rash ; rash	what you do shouldn't be rash
just say the offices are tastefully appointed he says ; appointed	he says to just say the offices are tastefully appointed
i 'm ashamed i own the stupid thing ; ashamed	owning the stupid thing makes me ashamed
affiliated publications inc. reversed a year-earlier third quarter net loss ; year-earlier	affiliated publications inc. reversed a third quarter net loss from a year-earlier
margin debt was at a record high ; record	the margin debt was so high it set a record
i 'm ashamed i own the stupid thing ; stupid	i am ashamed i own a thing that is stupid
for cathay pacific airways the smooth ride may be ending ; smooth	for cathay pacific airways what may be ending is their ride which has been smooth
gaf faces potential fines of 500,000 for each count ; potential	for each count fines of 500,000 assessed to gaf have potential
affiliated publications inc. reversed a year-earlier third quarter net loss ; third	affiliated publications inc. reversed a year-earlier net loss for the quarter third
analysts predict little or no near-term growth ; little	analysts predict near term growth that is none or little
and short-term the technicians may have their way ; short-term	and the technicians may have their way in the short-term
affiliated publications inc. reversed a year-earlier third quarter net loss ; net	the year-earlier third quarter loss that affiliated publications inc. reversed was net
but junk bonds took more hits ; more	but junk bonds took hits more
analysts predict little or no near-term growth ; near-term	analysts predict little or no growth in the near-term
it is known in the pentagon as the negative wedge ; negative	in the pentagon the wedge is known as negative
occasionally gross chromosome damage was visible ; gross	occasionally visible was chromosome damage which was gross
they 're really fashion items wrapped up in little jars ; little	they're really fashion items wrapped up in jars that are little
many economists expect the weakness to continue ; many	the number of economists that expect the weakness to continue are many.
disclosures are very poor in india ; poor	disclosures in india are very poor
south african gold stocks ended marginally firmer ; south	the african gold stocks that ended marginally firmer were south
complete details were n't immediately available ; complete	the details that were immediately available were not complete
shortage and crisis became buzz words although neither really applied ; buzz	although neither really applied shortage and crisis became words with buzz
south african gold stocks ended marginally firmer ; african	the gold stocks that ended marginally firmer were south african
similar proposals were defeated in at least 15 other states ; similar	proposals that were defeated in at least 15 other states were similar
needless to say he was talking about rico ; needless	to say he was talking about nico is needless
similar proposals were defeated in at least 15 other states ; least	similar proposals were defeated in 15 other states at least
lack of important needed information can cause fear ; important	the lack of needed information that can cause fear is important
they currently have large orders for cargo planes ; large	they currently have orders for cargo planes that are large
it 's a real face-to-face arm wrestling challenge to congress ; real	the face to face arm wrestling challenge to congress is real
that may be the last thing she needs ; last	that may be the thing she needs last
daiwa is one of the world 's largest securities firms ; largest	among the world's securities firms daiwa is one of the largest
it 's a real face-to-face arm wrestling challenge to congress ; face-to-face	the real arm wrestling challenge to congress is face to face
dr. lourie says the justice department interviewed him last july ; last	dr. lourie says the justice department interviewed him the july last
repeat customers also can purchase luxury items at reduced prices ; reduced	repeat customers also can purchase luxury items at prices that are reduced.
a 60-day to 65-day supply is considered normal ; 60-day	what's considered normal is a supply that's 65 to 60-day
cathay is taking several steps to bolster business ; several	the steps cathay is taking to bolster business are several
a 60-day to 65-day supply is considered normal ; 65-day	a supply is considered normal if it is 60-day to 65-day
yet his political setbacks mounted ; political	yet his setbacks that mounted were political
traders said most municipal bonds ended 1\/2 point higher ; most	traders said the quantity of municipal bonds which ended 1\/2 point higher was most
northern california braced for earthquake-related traffic jams ; earthquake-related	northern california braced for traffic jams that were earthquake-related
the companion tax-exempt funds add 71 billion ; tax-exempt	the companion funds that add 71 billion are tax-exempt
traders said most municipal bonds ended 1\/2 point higher ; municipal	municipal bonds ended 1\/2 point higher according to traders
sometimes they are constructive but often not ; constructive	sometimes but not often they are constructive
at applied mr. sim set growth as his first objective ; first	at applied mr. sim set growth as his objective that he puts first
the investors range from elderly widows to affluent professionals ; elderly	the investors range from affluent professionals to widows who are elderly
the modest sell-off which started on tuesday continued ; modest	the sell-off which started on tuesday and now continued was modest
noriega managed the whole thing ; whole	noriega managed the thing as a whole
the investors range from elderly widows to affluent professionals ; affluent	the investors range from elderly widows to professionals who are affluent
wisconsin toy has 71 retail stores primarily in discount settings ; retail	wisconsin toy has 71 stores primarily in discount settings which are retail
it 's bad soil he says ; bad	he says the soil is bad
he expects citicorp to take a similar step this year ; similar	the step he expects citicorp to take this year will be similar
this misguided policy could not prevent a british trade deficit ; misguided	the policy that could not prevent a british trade deficit was misguided
the outlook for corporate earnings is fairly bleak ; corporate	the outlook is fairly bleak for earnings defined as corporate
ortega cited renewed attacks by the u.s.backed rebels ; u.s.backed	ortega cited renewed attacks by rebels that were u.s.backed
this misguided policy could not prevent a british trade deficit ; british	this misguided policy could not prevent a trade deficit for the british
people have a different reputation country by country ; different	the reputations that people have from country to country are different
chiron another pharmaceutical concern is based in emeryville calif ; pharmaceutical	based in emeryville calif chiron is another concern that's pharmaceutical
artists and draftsmen need harder leads ; harder	artists and draftsmen need leads that are harder
many law school grads find classes never end ; many	the number of law school grads that find that classes never end are many
i refer essentially to petroleum electric power banking and newsprint ; electric	i refer essentially to petroleum banking newsprint and power that's electric
the market has been overly harsh to them ; harsh	to them the market has been overly harsh
we are almost left out of campus social activities ; social	we are almost left out of campus activities that are social
several projects he said are still on the drawing board ; several	projects still on the drawing board are several
with little competition the computer industry here is inefficient ; little	the computer industry here is inefficient because its competition is little
conspicuous by its absence is california ; conspicuous	by its absence california is conspicuous
average shares outstanding dropped to 75.8 million from 82.1 million ; average	shares outstanding dropped to 75.8 million from 82.1 million on average
it all adds up to a cold winter here ; cold	it all adds up to a winter here that's cold
the minimum unit is 100,000 ; minimum	100,000 is the unit minimum
average shares outstanding dropped to 75.8 million from 82.1 million ; outstanding	dropping to 75.8 million from 82.1 million were the average shares outstanding
cra is 49%-owned by rtz corp. of britain ; 49%-owned	rtz corp. of britain holds cra at a level that's 49%-owned
it 's good exercise he says ; good	he says it is exercise that is good
study halls complete with reference materials will be available ; complete	study halls will be available with reference materials which are complete
mr. locke teaches english and comparative literature at columbia university ; comparative	at columbia university mr. locke teaches english and literature that is comparative
the minimum unit is 100,000 ; minimum	the unit of 100,000 is the minimum
were we smart or just lucky ; smart	were we just lucky or smart
her instincts were capitalistic despite her background ; capitalistic	despite her background her instincts were capitalistic
but many of these stocks have now become expensive ; many	but the amount of these stocks which have now become expensive is many
imperial cup has annual sales of approximately 75 million ; annual	imperial cup has sales of approximately 75 million in a period that is annual
new management can take several steps to reduce dishonesty ; new	several steps can be taken to reduce dishonesty by the management that's new
at first we were unfazed ; first	we were unfazed at first
it 's hard to know if people are responding truthfully ; hard	to know whether or not people are responding truthfully is hard
the predictions of doom are premature she says ; premature	she says the predictions of doom are premature
new management can take several steps to reduce dishonesty ; several	to reduce dishonesty new management can take steps numbering several
the volatility was dizzying for traders ; dizzying	for traders the volatility was dizzying
but attendance is down from previous years ; previous	but attendance is down from years previous
and it 's important that we be accurate ; important	for us to be accurate is important
a hundred billion dollars in stock was subject to it ; subject	to a hundred billion dollars in stock it was subject
you talk about free time .what free time ; free	you talk about time that's free what time that's free
but what about all those non-duck ducks flapping over washington ; non-duck	but what about all those ducks flapping over washington which are non-duck
my vision is to change human consciousness towards touch ; human	my vision towards touch is to change consciousness that's human
the interview did not touch on singapore 's domestic affairs ; domestic	the interview did not touch on singapore's affairs that are domestic
a federal judge turned down the chapter 11 petition ; federal	the judge that turned down the chapter 11 petition was federal
some current rates exceed those on cds ; current	some of the rates that exceed those on cds are current
i want to add one more truck mr. huber says ; more	mr. huber says he wants to add one truck more
that is a little disturbing ms. kleinman said ; little	ms. kleinman said that is disturbing her a little
and she has this inexhaustible energy ; inexhaustible	and she has this energy that is inexhaustible
that is a little disturbing ms. kleinman said ; disturbing	ms. kleinman said that is a little disturbing
some hotels in the hurricane-stricken caribbean promise money-back guarantees ; hurricane-stricken	some hotels in the caribbean offering money back guarantees were hurricane stricken
again no such statement appears on the tapes ; such	again no statement appears on the tapes as such
but markets can operate with greater or lesser efficiency ; greater	but markets can operate with efficiency that is lesser or greater
some hotels in the hurricane-stricken caribbean promise money-back guarantees ; money-back	some hotels in the hurricane-stricken caribbean promise guarantees of money-back
but markets can operate with greater or lesser efficiency ; lesser	but markets can operate with efficiency that is greater or lesser
the offer made june 1 has been extended several times ; several	the amount of times an extension was made to the june 1st offer was several
meanwhile personal income edged up 0.3 % ; personal	meanwhile the income that edged up 0.3% was personal
appalled mr. green never paid the money he testified ; appalled	mr. green never paid the money he testified appalled
that 's ok mr. sagan replies ; ok	mr sagan replies that is is ok
there was no new-issue activity in the derivative market ; new-issue	in the derivative market there was no activity that was new issue
says mr. steidtmann i 'm looking for a bi-polar christmas ; bi-polar	mr. steidtmann says i 'm looking for a christmas that is bi-polar
the disk-drive maker disclosed a major fraud two months ago ; major	two months ago the disk-drive maker disclosed a fraud that was major
its 1.7 million-share offering was priced at 15 ; million-share	the offering priced at 15 was its 1.7 million share
pilgrim had been closed for 32 months ; closed	for 32 months pilgrim had been closed
there was no new-issue activity in the derivative market ; derivative	there was no new-issue activity in the market that is derivative
a disastrous farce in malaysia screamed the manchester guardian ; disastrous	a farce in malaysia that screamed the manchester guardian was disastrous
outside investors scarce since '86 are edging back ; outside	investors scarce since 1986 are edging back from the outside
now the push is on for more-distinctive shows ; more-distinctive	now the push is on for shows that are more distinctive
senate hears final arguments in impeachment trial of federal judge ; final	the arguments in the impeachment trial of a federal judge that the senate hears are final
outside investors scarce since '86 are edging back ; scarce	since 1986 the outside investors edging back have been scarce
senate hears final arguments in impeachment trial of federal judge ; federal	senate hears final arguments in impeachment trial of judge who is federal
but many predicted that the commercial disruption would be short-lived ; many	commercial disruption would be short-lived according to many
call it the we 're too broke to fight defense ; broke	call it we can't fight defense because we're too broke
but gaf 's bellwether role was short-lived ; bellwether	but short-lived was gaf's role as bellwether
bankamerica 's profit jumped 34 % in the third quarter ; third	bankamerica's profit jumped 34% in the quarter third
but many predicted that the commercial disruption would be short-lived ; commercial	many predicted that the short lived disruption would be commercial
some diaries simply are n't worth snooping in ; worth	some diaries simply dont get snooped in because they do not have the worth
his melodious confutatis was smoothly sung by bass brian matthews ; melodious	smoothly sung by bass brian matthews was his confutatis which was melodious
people start their own businesses for many reasons ; own	the reasons that people start their own businesses are their own
bond prices were little changed in sluggish activity ; changed	in sluggish activity bond prices were little changed
people start their own businesses for many reasons ; many	the reasons people start their own businesses are many
hostile thus entered the merger-acquisition lexicon ; hostile	thus what entered the merger-acquisition lexicon was hostile
bond prices were little changed in sluggish activity ; sluggish	bond prices were little changed in activity that was sluggish
polymerix makes lumber-like materials that it describes as plastic wood ; lumber-like	polymerix makes materials that it describes as plastic wood which are lumber-like
the current quarter he said looks fine ; current	he said what looks fine is the quarter that's current
polymerix makes lumber-like materials that it describes as plastic wood ; plastic	polymerix makes materials that are lumber like and though look like wood are plastic
hostile thus entered the merger-acquisition lexicon ; merger-acquisition	the merger-acquisition lexicon thus welcomed the word hostile
indirect subsidies through the fha for instance are little better ; indirect	the subsidies through the fha that are a little better are ones that are indirect
broader market averages were little changed in the latest session ; broader	the market averages little changed in the latest session were the ones which were broader
but there are no scientific data on this question ; scientific	but on this question there are no data that is scientific
broader market averages were little changed in the latest session ; changed	in the latest session broader market averages were little changed
the numbers were adjusted for usual seasonal fluctuations ; usual	the numbers were adjusted for seasonal fluctuations as usual
it will continue to be sold in the european market ; european	it will continue to be sold in the market that is european
broader market averages were little changed in the latest session ; latest	broader market averages were little changed in the session that was latest
but so-called outer month contracts finished higher ; so-called	the outer month contracts that finished higher were so called
the numbers were adjusted for usual seasonal fluctuations ; seasonal	the numbers were adjusted for usual fluctuations that are seasonal
there is after all big money in environmentalism ; big	there is after all money in environmentalism that's big
for the most part the changes were slight ; most	the changes were slight at most
but so-called outer month contracts finished higher ; outer	buy the contracts that finished higher for the month were so called outer
european drama has had better though still mixed fortunes ; european	drama that has had better though still mixed fortunes are european
european drama has had better though still mixed fortunes ; better	though still mixed fortunes european drama has had better
and much home-equity credit is used conservatively ; much	of home-equity credit used conservatively are much
he seems to be typical of many professional money managers ; typical	of many professional money managers he seems to be typical
european drama has had better though still mixed fortunes ; mixed	european drama has had better fortunes though still mixed
and much home-equity credit is used conservatively ; home-equity	and used conservatively is much credit in the category of home-equity
it 's also a fast fix for an ailing image ; fast	for an ailing image it's also a fix that's fast
everybody was afraid of him mr. ingersoll says ; afraid	mr ingersoll says that of him everybody was afraid
he seems to be typical of many professional money managers ; many	he seems to be typical of professional money managers that are many
this news raised hopes for further interest-rate cuts ; further	this news raised hopes for interest rate cuts further
it 's also a fast fix for an ailing image ; ailing	it was also a fast fix for an image that was ailing
he seems to be typical of many professional money managers ; professional	he seems to be typical of many money managers who are professional
municipals ended mixed while mortgage-backed and investment-grade corporate bonds rose ; mixed	mortgage-backed and investment-grade corporate bonds rose while municipals ended mixed
this news raised hopes for further interest-rate cuts ; interest-rate	this news raised hopes for further cuts in the interest-rate
anti-nuclear activists took a less positive view ; anti-nuclear	activists that took a less positive view were anti nuclear
the council plans to release its regional reports monthly ; regional	the reports that the council plans to release monthly are regional
municipals ended mixed while mortgage-backed and investment-grade corporate bonds rose ; mortgage-backed	municipals ended mixed while the corporate bonds that rose were investment-grade and mortgage-backed
china-bound freight streams through the territory 's port ; china-bound	streaming through the territory's port is freight that's china-bound
anti-nuclear activists took a less positive view ; positive	anti-nuclear activists took a view that was less positive
and they are a very odd team in any case ; odd	and in any case they are a team that is very odd
this is not nearly good enough ; good	for this to be enough it is not good
municipals ended mixed while mortgage-backed and investment-grade corporate bonds rose ; investment-grade	municipals ended mixed while corporate bonds rose if they were investment-grade
he confers big trading commissions on wall street firms ; big	he confers trading commissions on wall street firms which are big
radio programs and books have followed the daily television show ; daily	radio programs and books have followed the television show airing daily
reluctant advertisers try soft-sell spots ; reluctant	to try soft-sell spots advertisers are reluctant
in europe the dollar ended lower in dull trading ; dull	in europe the dollar ended lower in trading that was dull
reluctant advertisers try soft-sell spots ; soft-sell	reluctant advertisers try spots that are soft-sell
municipals ended mixed while mortgage-backed and investment-grade corporate bonds rose ; corporate	municipals ended mixed while what rose were mortgage-backed and investment-grade bonds that were corporate
he describes a drowned corpse as esther williams ; drowned	the corpse he described as esther williams was drowned
there is a reality to the excess energy he said ; excess	he said there is a reality to the energy that is excess
the dollar weakened against most other major currencies ; other	the dollar weakened against most major currencies of other
of course mr. wolf 48 years old has some savings ; old	of course mr. wolf has some savings because he's 48 years old
additional cable partners could boost subscribers even further ; additional	what could boost subscribers even further are cable partners who are additional
estimated and actual results involving losses are omitted ; estimated	what's omitted involving losses are results both actual and estimated
the dollar weakened against most other major currencies ; major	the other currencies that the dollar weakened against were major
in either case the investor faces three possible outcomes ; possible	in either case the investor faces three outcomes that are possible
estimated and actual results involving losses are omitted ; actual	results involving losses which are omitted are estimated and actual
but there did seem to be a retail activity pickup ; retail	the activity that seemed to pickup was retail
the suit seeks unspecified damages ; unspecified	the damages the suit seeks are unspecified
but these wide swings scare them to death ; wide	what scares them to death are these swings that are wide
with that authority of course goes an unambiguous accountability ; unambiguous	with that authority of course the accountability is unambiguous
ms. clifton had been executive financial assistant to the chairman ; executive	ms cliftons position as executive assistant to the chairman was financial
bloomingdale 's does an estimated 1.2 billion in annual sales ; annual	bloomingdale 's does an estimated 1.2 billion in sales which are annual
the company 's trustee f.e. agnew was unavailable for comment ; unavailable	there was no comment from the company's trustee f.e. agnew as he was unavailable
ms. clifton had been executive financial assistant to the chairman ; financial	the type of executive assistant to the chairman ms clifton had been was financial
foreign traders say the company is strapped for cash ; foreign	the traders that say the company is strapped for cash are foreign
some institutional traders loved the wild ride ; institutional	some traders that loved the wild ride were institutional
trading activity cooled off from monday 's sizzling pace ; sizzling	trading activity cooled off from monday which had a pace that was sizzling
foreign traders say the company is strapped for cash ; strapped	foreign traders say the companies cash is strapped
it now takes something really weird to inspire public outrage ; weird	to inspire public outrage it now takes something really weird
some institutional traders loved the wild ride ; wild	some institutional traders loved the ride that was wild
the japanese government does n't allow this ; japanese	the government that doesn't allow this is japanese
we 're very pleased with the new deal ; pleased	with the new deal we are very pleased
it now takes something really weird to inspire public outrage ; public	it now takes something really weird to inspire outrage from the public
this is a very tenacious ghost mr. warren says darkly ; tenacious	mr warren says darkly that the ghost is very tenacious
no doubt mr. dinkins has been a calming influence ; calming	no doubt mr dinkins is an influence that has been calming
we 're very pleased with the new deal ; new	we are very pleased with the deal that is new
the second factor spurring mega-issues is political ; second	as factors spurring mega-issues political is second
the bank has a negative net worth they say ; negative	they say the bank has a net worth that's negative
white children empty the wastepaper baskets and squeegee the windows ; white	the children who empty the wastepaper baskets and squeegee the windows are white
the bank has a negative net worth they say ; net	they say the bank has a negative worth in the column of net
second-tier companies are receiving even less per ton ; second-tier	the companies that are receiving even less per ton are second tier
an early battleground was the u.s. department of agriculture ; early	the us department of agriculture battleground was an early one
estimated and actual results involving losses are omitted ; actual	omitted results involving losses were estimated and actual
second-tier companies are receiving even less per ton ; less	per ton second-tier companies are receiving even less
many law firms sponsor their own programs ; many	law firms which sponsor their own programs are many
they want late-night shuttles to the biology labs ; late-night	they want shuttles to the biology labs to be late night
but the utility may not continue next year ; next	but the utility may not continue from this year to the next
himont is 81%-owned by montedison s.p a. of milan italy ; 81%-owned	the percentage owned by montedison s p a of milan italy is 81 percent owned
stock prices finished about unchanged friday in quiet expiration trading ; unchanged	stock prices finished friday in quiet expiration trading about unchanged
many law firms sponsor their own programs ; own	many law firms sponsor programs of their own
stock prices finished about unchanged friday in quiet expiration trading ; quiet	expiration trading of stock prices that finished unchanged friday were quiet
having only a republican measure makes the task harder ; republican	what makes the task harder is having a measure that's only republican
my position is well-known and well-stated he replied ; well-known	he replied my position is well-stated and well-known
many bankers view property-sector loans as particularly risky ; many	bankers that view property sector loans as particularly risky are many
the playoff series had riveted the 12-year-old giants fan ; 12-year-old	the playoff series had riveted the giants fan who was 12-year-old
you 'll see fewer gimmicks ; fewer	the number of gimmicks you will see are fewer
my position is well-known and well-stated he replied ; well-stated	he replied my position is well-known and well-stated
the reversal was even more evident among shorter-term treasury securities ; evident	among shorter-term treasury securities the reversal was even more evident
other mutual fund companies reported even lighter withdrawal requests ; other	mutual fund companies that reported even lighter wihdrawal requests were other
consumer stocks once again set the pace for blue-chip issues ; blue-chip	consumer stocks once again set the pace for issues in the area of blue-chip
but sassy has a different spirit ; different	but sassy has a spirit that is different
the reversal was even more evident among shorter-term treasury securities ; shorter-term	the reversal was even more evident among treasury securities that were shorter-term
other mutual fund companies reported even lighter withdrawal requests ; mutual	even lighter withdrawal requests were reported by other fund companies in the class of mutual
he is a mechanical engineer not an atmospheric chemist ; mechanical	while he is not an atmospheric chemist the type of engineer he is is mechanical
the buy-out group had no firm financing for the plan ; firm	the buy-out group had no financing for the plan that was firm
other mutual fund companies reported even lighter withdrawal requests ; lighter	other mutual fund companies reported withdrawal requests that were even lighter
these guys prey on human frailties ; human	these guys prey on frailties that are human
more elderly maintain their independence ; more	elderly that maintain their independence is more
nasdaq 's gain was led by its biggest industrial stocks ; biggest	the industrial stocks led by nasdaqs gain were its biggest
more elderly maintain their independence ; elderly	of more that maintain their independence are elderly
they want a 24-hour library ; 24-hour	they want a library that's 24-hour
he is a mechanical engineer not an atmospheric chemist ; atmospheric	he is a mechanical engineer not a chemist specializing in the atmospheric
nasdaq 's gain was led by its biggest industrial stocks ; industrial	nasdaq's gain was led by its biggest stocks categorized as industrial
they will be the next hot magazines ; next	they will be the hot magazines that come next
the recent sharp stock market decline exacerbated those concerns ; recent	the sharp stock market decline which exacerbated those concerns was recent
both reflect the dismissal of lower-level and shorter-tenure executives ; lower-level	both reflect the dismissal of executives that are shorter tenure and lower level
they will be the next hot magazines ; hot	they will be the next magazines that are hot
their opposition helped scare off some japanese banks ; japanese	their opposition helped scare off some banks owned by the japanese
the recent sharp stock market decline exacerbated those concerns ; sharp	exacerbating those concerns was the recent stock market decline which was sharp
the company earned 6.6 million in the year-earlier quarter ; year-earlier	the company earned 6.6 million in the quarter that was a year-earlier
both reflect the dismissal of lower-level and shorter-tenure executives ; shorter-tenure	both reflect the dismissal of executives that were of lower-level and shorter-tenure
they got a transaction that 's good for both companies ; good	both companies got a transaction that was good
her new line of work has some perils ; new	her line of work that has some perils is new
this leads to a very special sense of urgency ; special	the sense of urgency this leads to is very special
the company 's sales flattened during 1989 's first half ; first	the company's sales flattened during the half of 1989 which came first
any fool can publish a money-losing magazine ; money-losing	any fool can publish a magazine that is money-losing
long-term care insurance gains favor ; long-term	the care insurance that gained favor was long term
the 30-share index settled 42.0 points lower at 1678.5 ; 30-share	the index which settled 42.0 points lower at 1678.5 was the 30-share
revenue was flat at 1.3 billion ; flat	revenue was 1.3 billion flat
other companies figure they ca n't avoid the market ; other	companies that figure they can't avoid the market are other
the 30-share index settled 42.0 points lower at 1678.5 ; lower	the 30-share index settled at 1678.5 which was 42.0 points lower
mervin lung remains chairman and chief executive officer ; chief	mervin lung remains chairman and executive officer chief
measures of manufacturing activity fell more than the overall measures ; overall	measures of manufacturing activity fell more than the measures overall
mr. goldberg is the sole general partner in rose partners ; sole	mr goldbergs role as general partner in rose partners is sole
the moisturizer introduced in 1962 had a dowdy image ; dowdy	the moisturizer introduced in 1962 had an image that was dowdy
the current debt limit expires oct. 31 ; current	the debt limit which expires oct. 31 is the one that's current
mr. goldberg is the sole general partner in rose partners ; general	in rose partners mr. goldberg is the sole partner general
i thought your editorial was factually accurate and deliberately elucidative ; accurate	i thought your editorial was deliberately elucidative and factually accurate
the work force provides the third arm of the alliance ; third	the arm of the alliance that the work force provides is its third
a big reason for the chemical price retreat is overexpansion ; big	as a reason for the chemical price retreat overexpansion is big
ortega had threatened to end a 19-month-old ceasefire ; 19-month-old	the ceasefire that ortega had threatened to end was 19 months old
and some fund groups said investors actually became net buyers ; net	and some fund groups said investors actually became buyers in the category of net
tymnet is a major network linking computers ; major	tymnet is a network linking computers that is major
unease is widespread among exchange members ; widespread	among exchange members unease is widespread
corporate profits may also dip initially ; corporate	the profits that also may dip initially are corporate
the fundamentals are pretty strong mr. dreman says ; strong	mr. dreman says the fundamentals are pretty strong
when industries were weak it protected them ; weak	it protected them when industries were weak
but at this point that may just be wishful thinking ; wishful	but at this point that may just be thinking that is wishful
that 's not fair they 're not all fat ; fair	they are not all fat so that is not fair
nor is cbs a shoo-in to get blockbuster ratings ; blockbuster	nor is cbs a shoo-in to get ratings considered to be blockbuster
but the fed move was a small gesture traders said ; small	traders said that the fed move was only a gesture that was small
but for photofinishers developing costs for black-and-white film are higher ; black-and-white	but for photofinishers film developing costs are higher for film that's black-and-white
there were no new issues ; new	there were no issues that were new
reward el espectador 's courage with real support ; real	reward el espectador 's courage with support that is real
indeed abortion-rights activists still face their greatest tests ; greatest	the tests that abortion rights activists still face are indeed their greatest
but one far-afield effect is still with us ; far-afield	but still with us is one effect that's far-afield
east germans rallied in three cities to demand democratic freedoms ; democratic	east germans rallied in three cities to demand freedoms which were democratic
the analysts say their gloomy forecasts have a flip side ; gloomy	the analysts say they have a flip side to their forecasts that are gloomy
then he unleashed his own unstoppable attack ; own	the unstoppable attack that he unleashed was his own
expansion plans also include acquisitions in growing foreign markets ; foreign	expansion plans also include acquisitions in growing markets which are foreign
poachers would control the underground trade ; underground	poachers would control the trade that is underground
the analysts say their gloomy forecasts have a flip side ; flip	the analysts say their gloomy forecasts have another side on the flip
then he unleashed his own unstoppable attack ; unstoppable	his own attack that he unleashed was unstoppable
a further problem is razor-thin profits ; further	the problem of razor-thin profits was further
now was that a quarter cup or a half cup ; half	was that cup a quarter or half
i think you have to give greenspan a good rating ; good	i think you have to give greenspan a rating that is good
his humility gives him a much better chance of success ; better	his chance of success that his humility gives him is much better
a further problem is razor-thin profits ; razor-thin	a further problem is profits that are razor-thin
they looked at the miniature and saw a giant folly ; giant	they looked at the miniature and saw a folly which was giant
also the big board met with angry stock specialists ; angry	the stock specialists the big board met with were angry
he became angry in return ; angry	in return he became angry
but this is almost an underground activity ; underground	but this is an activity that is almost underground
they serve the industries and the special-interest groups ; special-interest	they serve the industries and the groups of special-interest
the old and revised numbers both include over-allotment provisions ; old	the numbers that include over allotment provisions are revised and old
it 's just not cost efficient he says ; efficient	he says it is just not cost efficient
limiting care wo n't be easy or popular ; easy	limiting care will not be popular or easy
heady stuff it 's not ; heady	it's not stuff that's heady
the old and revised numbers both include over-allotment provisions ; over-allotment	the old and revised numbers both include provisions which are over-allotment
broader averages also posted modest gains ; broader	averages that posted modest gains were broader
blue chips led the march up in heavy trading ; blue	the chips that led the march up in heavy trading were blue
broader averages also posted modest gains ; modest	broader averages also posted for gains that are modest
what could imply more safety than investing in government bonds ; more	besides investing in government bonds could anything imply safety more
blue chips led the march up in heavy trading ; heavy	blue chips led the march up in trading that was heavy
but the complex language is n't the only reason ; complex	the only reason is not the language which is complex
the farmer at the next truck shouts wheat ; next	the farmer that shouts wheat is at the truck that's next
also profit rose 19 % in the third quarter ; third	also profit rose 19% in the quarter third
but trelleborg still must clear some tough hurdles ; tough	but trelleborg still must clear some hurdles which are tough
but the complex language is n't the only reason ; only	but the reason isn't the complex language only
the minimum unit is 100,000 ; minimum	100,000 is the unit minimum
michael late yesterday announced a 3.8 million stock buy-back program ; buy-back	michael late yesterday announced a 3.8 million program for stock buy-back
nissan will introduce a completely revamped sentra next fall ; next	nissan will introduce a completely revamped sentra in the fall coming next
population drain ends for midwestern states ; midwestern	population drain ends for states that are midwestern
other temperature data show similar unexplained swings ; other	similar unexplained swings are shown in temperature data categorized as other
spiegel is 84%-controlled by the otto family of west germany ; 84%-controlled	the otto family of west germany has a portion of spiegel which is 84%-controlled
everybody 's finger is one inch closer to the button ; closer	to the button everybody's finger is one inch closer
the treasury 's benchmark 30-year bond rose 1\/8 point ; 30-year	the bond that rose 1\/8 point was the treasury's benchmark 30-year
and pregnant women are fat ; pregnant	and the women that are fat are pregnant
the polish rat will eat well this winter ; polish	the rat that will eat well this winter is polish
that compares with 3.5 % butterfat for whole milk ; whole	that compares with 3.5% butterfat for milk that's whole
usx is funneling drilling pipe to steel-hungry soviet union ; steel-hungry	usx is funneling drilling pipe to the soviet union who is steel hungry
shrubs and flowers give it a pleasing and non-fortress-like appearance ; non-fortress-like	shrubs and flowers give it a pleasing appearance that's non-fortress-like
his tuesday night team the leftovers is in first place ; first	the place his tuesday night team left the leftovers was first
