chemical profits fell to 78 million from 98 million ; fell	the falling of the chemical profits went from 98 million to 78 million
all estimates exclude highway repair which could exceed 1 billion ; exclude	the excluding of highway repair from all estimates could still exceed 1 billion
and he has worked to shed his raider image ; worked	the working to shed his raider image was done by him
the industrial average closed down only 3.69 points at 2659.22 ; closed	the closing of the industrial average was down only 3.69 points at 2659.22
all estimates exclude highway repair which could exceed 1 billion ; exceed	the exceeding of 1 billion exclude highway repair from all estimates
and he has worked to shed his raider image ; shed	the shedding of his raider image is something he has worked to do
you have n't seen the full effect of that yet ; seen	seeing the full effect of that is what you have not done yet
i do n't think anyone left the place whistling dixie ; whistling	there was no whistling of dixie done by anyone leaving the place
still some aid is moving westward from washington almost immediately ; moving	the moving of some aid westward from washington happened almost immediately
opponents of the cut are playing hardball ; playing	the playing of hardball was done by the opponents of the cut
it does n't appear to be getting worse ; appear	the appearing of it getting worse is not happening
it has not however made a formal proposal ; made	the making of a formal proposal has not occurred
meanwhile personal income edged up 0.3 % ; edged	the edging of income up 0.3 percent was personal
but he adds i was not acting as a messenger ; acting	the acting as a messenger he claimed was not by him
revenue nearly tripled to 479 million from 160 million ; tripled	the tripling of the revenue went from 160 million to 479 million
it does n't appear to be getting worse ; getting	the getting worse does not appear to be happening to it
compaq is already taking aim at zenith 's market share ; taking	taking aim at zenith 's market share already is compaq
safeco fell 1\/8 to 32 5\/8 on 462,900 shares ; fell	the falling of safeco shares went from 1v8 to 32 5v8 on 462,900
harsco declined to say what country placed the order ; declined	the declining to say what country placed the order comes from harsco
the disk-drive maker disclosed a major fraud two months ago ; disclosed	disclosure of a major fraud two months ago was done by the disk-drive maker
outside investors scarce since '86 are edging back ; edging	the edging back of outside investors since 1986 has been scarce
logic plays a minimal role here ; plays	the playing of logic takes a minimal role here
she said that impact ca n't be reasonably assessed yet ; assessed	she said that the assessment of the impact can't be done yet
harsco declined to say what country placed the order ; say	saying what country placed the order was declined by harsco
shares of three brokerage firms rose after they reported earnings ; rose	the rising of shares from three brokerage firms happened after they reported earnings
the venture cost quebecor 12 million mr. peladeau says ; cost	the cost of the venture for quebecor was 12 million mr. peladeau says
the consequences of building empires with sand are showing up ; building	the building of empires with sands have consequences which are showing up
shares of three brokerage firms rose after they reported earnings ; reported	after their reporting of earnings shares of three brokerage firms rose
the venture cost quebecor 12 million mr. peladeau says ; says	the saying that the venture will cost quebecor 12 million came from mr peladeau
harsco declined to say what country placed the order ; placed	the placing of the order by harsco declined to mention what country it was in
i see it as a sewage treatment plant he says ; see	seeing it as a sewage treatment plant is what he says he does
even so few had ever dealt with an earthquake ; dealt	the dealing of an earthquake had been experienced by so few
the consequences of building empires with sand are showing up ; showing	the showing up of the consequences is due to building empires with sand
i consider this a second career he said ; consider	the considering this a second career was said by him
most other states have enacted similar bans ; enacted	enacting similar bans was done by most other states
the numbers were adjusted for usual seasonal fluctuations ; adjusted	the adjusting of numbers was done for usual seasonal fluctuations
he is negotiating a rich book contract to boot ; negotiating	the negotiating of a rich book contract is being done by him
and much home-equity credit is used conservatively ; used	the using of a lot of home equity is done conservatively
i do n't think we do now he says ; think	the thinking that we do not now was said by him
people wonder what 's going to happen next ; wonder	the wondering of what is going to happen next occurs by people
the woman won the bet ; won	the winning of the bet was done by the woman
they stopped short of resuming diplomatic ties severed in 1979 ; stopped	the stopping short of resuming diplomatic ties was severed in 1979
its plan is set up as an independent agency ; set	the setting up of the plan is done as an independent agency
who is going to carry the water ; carry	carrying the water is going to be done by whom
should the rest of the series be played at all ; played	the playing of the rest of the series is in question
they stopped short of resuming diplomatic ties severed in 1979 ; resuming	the resuming of diplomatic tied severed in 1979 was stopped short by them
the june killings magnified the problems ; magnified	the magnifying of the problems occurred because of the june killings
and ibm said it expects the costs to continue climbing ; said	and saying it expects the costs to continue climbing was ibm
they stopped short of resuming diplomatic ties severed in 1979 ; severed	the severing of diplomatic ties in 1979 had been stopped short of resuming
warnaco also owns warners another major intimate apparel maker ; owns	also owning warners another major intimate apparel maker is warnaco
and ibm said it expects the costs to continue climbing ; expects	and the expectation of costs to continue climbing was said by ibm
but he warned the currency will remain at risk ; warned	the warning by him was that the currency will remain at risk
municipals ended mixed while mortgage-backed and investment-grade corporate bonds rose ; ended	ending mixed were municipals while mortgage backed and investment grade corporate bonds rose
his success is easy to understand ; understand	the understanding of his success is easy
municipals ended mixed while mortgage-backed and investment-grade corporate bonds rose ; rose	the rise of mortgage backed and investment grade corporate bonds happened while municipals ended mixed
and ibm said it expects the costs to continue climbing ; continue	the continuing of climbing costs are expected by ibm
and ibm said it expects the costs to continue climbing ; climbing	climbing is what ibm said it expects the costs to continue doing
hotel-casino operators play down the possibility of a labor shortage ; play	the playing down of the possibility of a labor shortage comes from hotel casino operators
toyota motor fell 40 to 2,680 ; fell	the falling of toyota motor was 40 to 2680
if this were 1949 mr. boren might even succeed ; succeed	there might even be success for mr. boren if this were 1949
estimated and actual results involving losses are omitted ; omitted	omitted are estimated and actual results involving losses
we have no further developments to report he said ; report	reporting that we have no further developments is what he said
we have no further developments to report he said ; said	the saying of there being no further developments for them came from him
the yield rose to 5.38 % ; rose	the rising of 5.38 percent was to the yield
but it does n't always work so smoothly ; work	the working does not always happen so smoothly
but these wide swings scare them to death ; scare	the scaring of them to death was because of the wide swings
the state of new hampshire has favored that plan ; favored	favoring that plan was the state of new hampshire
we do n't need cartoons anymore ; need	a need for cartoons isn't something we have anymore
it 's worse than i thought she said ; thought	the thinking that it is worse comes from her
bloomingdale 's does an estimated 1.2 billion in annual sales ; estimated	the estimating of 1.2 billion in annual sales is for bloomingdales
joann s. lublin in london contributed to this article ; contributed	the contributing of this article comes from joann s lublin
it 's worse than i thought she said ; said	saying it is worse than i thought is what she did
when it comes to money once bitten 2,000 times shy ; bitten	the biting of 2000 times shy comes from money
the advance felt more like a technical bounce he said ; felt	the feeling of the advance was more like a technical bounce he said
how do readers feel about the magazine ; feel	the feeling of the magazine by readers has been questioned
foreign traders say the company is strapped for cash ; say	saying the company is strapped for cash are foreign traders
then he jumped into the market ; jumped	the jumping into the market was by him
the future of the forest remains uncertain ; remains	the remaining forest has an uncertain future
the advance felt more like a technical bounce he said ; said	saying that the advance felt more like a technical bounce was he
sounds great or does it ; sounds	the sounds were great
the shuttle is slated to return monday to california ; slated	slated to return monday to california is the shuttle
all you get is risk ; get	the getting is nothing but risk
second-tier companies are receiving even less per ton ; receiving	the receiving by second tier companies are even less per ton
the shuttle is slated to return monday to california ; return	the return of the shuttle is slated on monday in california
rounding-off keeps them at 1 ; keeps	the keeping them at 1 is by rounding off
you 'll see fewer gimmicks ; see	the sight of fewer gimmicks is what you'll have
revenue jumped 22 % to 7.89 billion from 6.46 billion ; jumped	the jump in revenue was 22% from 6.46 billion to 7.89 billion
both issues are dated oct. 31 ; dated	dating oct. 31 are both issues
about 518 million of debt is affected ; affected	the affect is to about 518 million of debt
mr. tait say he does n't blame lilly ; say	the saying that he does not blame lilly comes from mr tait
the dollar finished mixed while gold declined ; finished	the finishing of the dollar was mixed while gold declined
sales rose 2.9 % to 329.2 million from 320 million ; rose	rising 2.9 % to 329.2 million from 320 million were sales
the journal also will offer expanded volume and frequency discounts ; offer	the offering by the journal will include expanded volume and frequency discounts
mr. tait say he does n't blame lilly ; blame	the blaming will not include lilly says mr tait
the journal also will offer expanded volume and frequency discounts ; expanded	the expanding of volume and frequency discounts comes from the journal
the dollar finished mixed while gold declined ; declined	the decline of gold happened while the dollar finished mixed
these guys prey on human frailties ; prey	preying on human frailties are these guys
mrs. marcos 's trial is expected to begin in march ; expected	the expectation is for mrs. marcos's trial to begin in march
trustee who monitored settlement payments to dalkon shield claimants quits ; monitored	the monitoring of the settlement payments to dalkon shield claimants was done by a trustee who quit
mrs. marcos 's trial is expected to begin in march ; begin	the beginning of mrs. marcos 's trial is expected to be in march
they want a 24-hour library ; want	wanting a 24 hour library are they
trustee who monitored settlement payments to dalkon shield claimants quits ; quits	quitting is the trustee who monitored settlement payments to dalkon shield claimants
people in glass houses tend to look stoned ; tend	the tending to look stoned happens to people in glass houses
phillips and arco posted declines ; posted	the posting of the declines was done by phillips and arco
people in glass houses tend to look stoned ; look	the looking of people who appear stoned are in glass houses
and he added that manufactured goods exports are still rising ; added	the addition he made was that manufactured goods exports are still rising
but the issue is stickier than it seems ; seems	the seeming is that the issue is stickier
people in glass houses tend to look stoned ; stoned	the stoning look of people tend to happen to those who live in glass houses
and he added that manufactured goods exports are still rising ; rising	the rising of the manufactured goods exports was something that he added
the recent sharp stock market decline exacerbated those concerns ; exacerbated	the exacerbating concerns were caused by the recent sharp stock market decline
apparently the commission did not really believe in this ideal ; believe	the believing in this ideal was not done by the commission
the transaction also would combine fresenius usa and delmed ; combine	combining fresenius usa and delmed is what the transaction would also do
they got a transaction that 's good for both companies ; got	in getting a transaction for the companies both got one that is good
expect brushbacks but no beanballs says mr. mcenaney ; expect	the expectation is brushbacks but no beanballs says mr. mcenaney
a beatrice spokesman did n't return calls seeking comment ; return	the return of calls seeking comments was not made by a beatrice spokesman
expect brushbacks but no beanballs says mr. mcenaney ; says	saying to expect brushbacks but no beanballs is mr mcenaney
a private farmer never wastes anything ; wastes	the wasting of anything is never done by a private farmer
this leads to a very special sense of urgency ; leads	the leading of a sense of urgency was very special
the 30-share index settled 42.0 points lower at 1678.5 ; settled	the settling of the 30 share index was 42.0 points lower at 1678.5
he added we learned a lesson in 1987 about volatility ; added	adding that we learned a lesson in 1987 about volatility is what he did
prices of high-yield high-risk corporate securities ended unchanged ; ended	the end left high-yield high-risk corporate securities prices unchanged
minicar output more than tripled ; tripled	more than tripling was minicar output
he added we learned a lesson in 1987 about volatility ; learned	learning a lesson in 1987 about volatility was what we did he added
peter gumbel in moscow contributed to this article ; contributed	the contributing to this article was by peter gumbel in moscow
those concerns are n't expressed in public ; expressed	public expression of those concerns is not done.
mission resource partners lost 5 1\/4 to 14 1\/8 ; lost	the loss of 5 1\/4 to 14 1\/8 was suffered by mission resource partners
revenue rose 15 % to 534.3 million from 464.7 million ; rose	rising 15 % to 534.3 million from 464.7 million was revenue
in five minutes the dow industrials climbed almost 30 points ; climbed	the climbing of the dow industrials almost 30 points happened in 5 minutes
he has mastered the art of survival ; mastered	the mastering of the art of survival is something he has done
the paris bank does n't publish that figure ; publish	publication of that figure is something the paris bank does not do
cable & wireless plc of britain won the other license ; won	winning the other license was cable & wireless plc of britain
the entire division employs about 850 workers ; employs	the employing of about 850 workers is done by the entire division
the stock fell 75 cents ; fell	the falling of the stock was by 75 cents
the moisturizer introduced in 1962 had a dowdy image ; introduced	the introducing of the moisturizer had a dowdy image in 1962
we were reassured they would stand behind the company ; reassured	reassurance that they would stand behind the company is what we were given
we were reassured they would stand behind the company ; stand	a stand behind the company is something we were reassured they would do
the work force provides the third arm of the alliance ; provides	providing the third arm of the alliance is the work force
nbc 's winning streak has been canceled ; winning	the winning of the streak by nbc has been canceled
affiliated publications inc. reversed a year-earlier third quarter net loss ; reversed	the reversing of a year earlier third quarter net loss came from affiliated publications inc
nbc 's winning streak has been canceled ; canceled	the cancellation was of nbc 's winning streak
and some fund groups said investors actually became net buyers ; said	the saying that some fund groups actually became net buyers came from investors
the transaction is expected to close around year end ; expected	expecting to close around year end is the transaction
and some fund groups said investors actually became net buyers ; became	and becoming net buyers is what some fund groups said investors were actually doing
corporate profits may also dip initially ; dip	the dipping of corporate profits may also happen initially
the transaction is expected to close around year end ; close	closing around year end is what the transaction is expected to do
why did east bloc participants unanimously endorse market-based pollution approaches ; endorse	the unanimous endorsing of the market based pollution approaches by the east bloc participants was questioned
it could do damage to us ; do	the doing of damage could happen to us
the suit seeks in excess of 350,000 in damages ; seeks	seeking in excess of 350000 in damages is the suit
but out on cobb parkway ted negas sees it differently ; sees	seeing it differently is what ted negas is doing out on cobb parkway
revenue rose 23 % to 100 million from 81.6 million ; rose	the rising of the revenue went from 23 % to 100 million from 81.6 million
amerada hess corp. and occidental petroleum corp. reported higher earnings ; reported	the reporting of higher earnings comes from amerada hess corp and occidental petroleum corp
manufacturers have survived the turmoil in china largely unscathed ; survived	the surviving of the turmoil in china was done by the manufacturers largely unscathed
now the personal-computer revolution is finally reaching japan ; reaching	reaching japan now finally is the personal-computer revolution
it does prolong the pain somewhat ; prolong	the prolonging of pain occurs somewhat by it
the notice also grants relief for certain estate-tax returns ; grants	the granting also of relief for certain estate-tax returns is done by the notice
they are starting to buy growth stocks ; buy	buying growth stocks is what they are starting to do
they 're really fashion items wrapped up in little jars ; wrapped	the wrapping up of fashion items in little jars is what they really are
east germans rallied in three cities to demand democratic freedoms ; rallied	the rally of the east germans was in three cities to demand democratic freedoms
or land in russia so often ; land	the landing happens in russia so often
i care very much for this post he says ; care	the caring of this post is something he does very much he says
east germans rallied in three cities to demand democratic freedoms ; demand	the demanding of democratic freedoms was rallied by east germans in three cities
the cbs official said that price sounded fine ; said	saying that price sounded fine was the cbs official
andy zipser in dallas contributed to this article ; contributed	contributing to this article was andy zipser in dallas
but not everybody was making money ; making	the making of money was not done by everybody
the cbs official said that price sounded fine ; sounded	sounding fine is what the cbs official said of that price
but burger king operators independently confirm using michael 's product ; confirm	the confirmation about using michael's product however is made independently by burger king operators
needless to say he was talking about rico ; say	the saying that he was talking about rico is needless
its many lively stories include the gutfreund-postel holiday cheer imbroglio ; include	including the gutfreund postel holiday cheer imbroglio are its many lovely stories
but burger king operators independently confirm using michael 's product ; using	the using of michael's product is independently confirmed by burger king operators
needless to say he was talking about rico ; talking	talking about rico is what he was doing needless to say
no mr. lantos 's complaints simply wo n't wash ; wash	the washing of mr lantos complaints will not happen
here they are searching for a higher price ; searching	the searching for a higher price is something they are currently doing
mr. drabinsky could n't be reached for comment ; reached	the reaching for comment by mr drabinsky didn't occur
revenue dropped 5.4 % to 3.48 billion from 3.68 billion ; dropped	the drop in revenue was 5.4% from 3.68 billion to 3.48 billion
expansion plans also include acquisitions in growing foreign markets ; include	the including of acquisitions in growing foreign markets was also part of expansion plans
we wo n't comment on them ; comment	the commenting on them won't come from us
we 're not rushing into anything ; rushing	the rushing into anything was not done by us
to ask those questions is to answer them ; ask	the asking of those questions is to answer them
expansion plans also include acquisitions in growing foreign markets ; growing	growing foreign market acquisitions are included in expansion plans.
to ask those questions is to answer them ; answer	the answering of those questions happens after they are asked
poachers would control the underground trade ; control	controlling the underground trade is what poachers would do
asilone an antacid was sold to boots plc london ; sold	the selling of the antacid asilone was to boots plc london
sales rose 14 % to 715 million from 625.4 million ; rose	the rise of 14% from 625.4 million to 715 million was in sales
broader averages also posted modest gains ; posted	the posting of modest gains is from broader averages
a panic on wall street does n't exactly inspire confidence ; inspire	the inspiring of confidence is not exactly what a panic on wall street does
everyone around me lives well ; lives	the living of everyone around me is done well
but readers may well feel the pangs of recognition ; feel	the feeling of pangs of rejection could come for readers
but some players were quick to seize the moment ; seize	the seizing of the moment was done by quick players
repeat customers also can purchase luxury items at reduced prices ; purchase	the purchasing of luxury items at reduced prices can be done by repeat customers
the polish rat will eat well this winter ; eat	the eating by the polish rat this summer will be done well
the yield on the issue slipped to 7.92 % ; slipped	slipping to 7.92 % was the yield on the issue
more-detailed reports followed and attracted even less notice ; followed	the following of more detailed reports attracted even less notice
all this is causing convulsions in professional football ; causing	the causing of convulsions is in professional football
but it 'll sure make you poorer ; make	the making of you poorer will be done by it
its contract expires dec. 1 ; expires	the expiration of its contract is dec. 1
more-detailed reports followed and attracted even less notice ; attracted	attracting even less notice were more-detailed reports that followed
it did n't provide details of setup costs ; provide	the providing of details did not include setup costs
mr. carpenter denies the speculation ; denies	the denying of the speculation comes from mr carpenter
a rake 's progress means branching out ; means	the meaning of progress is a rakes branching out
a 14 % inflation rate dropped below 5 % ; dropped	the dropping of the inflation rate went from 14% to below 5 %
you just call your broker and say buy or sell ; call	the calling of your broker is if you want to buy or sell
you just call your broker and say buy or sell ; say	the saying of buy or sell occurs when you call your broker
so far this list does n't change our view ; change	the changing of our view isn't affected by this list so far
you just call your broker and say buy or sell ; buy	buying or selling is what you just call your broker and say
overall salomon reported program trading volume of 75.2 million shares ; reported	the report of salomon included a program trading volume of 75.2 million shares
you just call your broker and say buy or sell ; sell	the selling or buying can be done when you call your broker
they ca n't afford to stay out of hdtv ; afford	the affording to stay out of hdtv is something they cannot do
dictation device 's saga plays back a lesson ; plays	the playing back of a lesson was by dictation devices saga
they ca n't afford to stay out of hdtv ; stay	staying out of hdtv is something they can't afford to do.
for the prior year deposits exceeded withdrawals by 8.8 billion ; exceeded	exceeding withdrawals by 8.8 billion for the prior year were deposits
the modest sell-off which started on tuesday continued ; started	the start of the modest sell off on tuesday has continued
coal earnings rose to 26 million from 21 million ; rose	a rise to 26 million from 21 million happened to coal earnings
the modest sell-off which started on tuesday continued ; continued	the continuing of the modest sell off had started on tuesday
hilton rose 2 7\/8 to 100 for example ; rose	the rising example from hilton was 2 7v8 to 100
this misguided policy could not prevent a british trade deficit ; prevent	the preventing of a british trade deficit could not occur due to the misguided policy
most bills are drafted by bureaucrats not politicians ; drafted	the drafting of most bills is done by bureaucrats, not politicians
darman hopes to prod congress to finish a deficit plan ; hopes	hoping to prod congress to finish a deficit plan is darman
chiron another pharmaceutical concern is based in emeryville calif ; based	based in emeryville calif is chiron another pharmaceutical concern
the interviews took place two years ago ; took	the taking place of the interviews was two years ago
many law school grads find classes never end ; find	finding classes never end are many law school grads
it 's contrary to common sense she added ; added	the adding from her is that it was contrary to common sense
darman hopes to prod congress to finish a deficit plan ; prod	the prodding of congress to finish a deficit plan is what darman hopes for
darman hopes to prod congress to finish a deficit plan ; finish	the finishing of a deficit plan darman hopes will be a prod to congress
mr. marinaro could n't immediately be reached for comment ; reached	reaching mr marinaro for comment could not immediately be done
many law school grads find classes never end ; end	ending is what many law school grads find classes never do
time eluded paramount by acquiring warner communications inc ; eluded	the eluding of time by paramount was due to acquiring warner communications inc
the official asked not to be named ; asked	the asking not to be named came from the official
the official asked not to be named ; named	naming of the official was asked not to be done
time eluded paramount by acquiring warner communications inc ; acquiring	the acquiring of warner communications inc by paramount caused them to elude time
in indianapolis lilly declined comment ; declined	the declining of lilly to comment was in indianapolis
for some banks that 10 % ceiling created problems ; created	the creation of problems for some banks was caused by that 10% ceiling
revenue rose 11 % to 8 billion from 7.2 billion ; rose	the rising of revenue was 11 percent from 7.2 billion to 8 billion
even so his bill is given little chance of passage ; given	given little chance of passage is his bill
inco shares fell after the announcements ; fell	falling after the announcements is what inco shares did
others preach the gospel of buying only blue-chip growth stocks ; preach	the preaching by others is the gospel of buying only blue chip growth stocks
it 's very much a growing concern ; growing	there has been a growth in the concern
average shares outstanding dropped to 75.8 million from 82.1 million ; dropped	the dropping of average outstanding shares was from 82.1 million to 75.8 million
said the spokeswoman the whole structure has changed ; said	saying the whole structure has changed was the spokeswoman
others preach the gospel of buying only blue-chip growth stocks ; buying	the buying of only blue chip growth stocks is preached as the gospel by others
said the spokeswoman the whole structure has changed ; changed	the changing of the whole structure happened said the spokeswoman
now comes the pool flap ; comes	the coming now is the pool flap
at first we were unfazed ; unfazed	unfazed is what we were at first
digital is promising a new approach ; promising	promising a new approach is digital
does this signal another black monday is coming ; signal	does the signaling mean that another black monday is coming
lawrence insurance underwrites mostly primary insurance a company spokesman said ; underwrites	underwriting primary insurance is what lawrence insurance mostly does said a company spokesman
does this signal another black monday is coming ; coming	the coming of another black monday could occur based on this signal
lawrence insurance underwrites mostly primary insurance a company spokesman said ; said	saying that lawrence insurance underwrites mostly primary insurance was a company spokesman
mccaw lost 8 % or 3 1\/2 to 40 ; lost	losing 8 percent or 3 1\/2 to 40 was mccaw
are corporate profits distributed fairly ; distributed	the distributing of corporate profits fairly are questioned
nonsense she told an interviewer yesterday on london weekend television ; told	the telling of nonsense in an interview yesterday on london weekend television was from her
the arabs had tried embargos before ; tried	the trying of embargos had been done by the arabs before
olivetti reportedly began shipping these tools in 1984 ; began	the beginning of the shipment of these tools was in 1984 as reported by olivetti
of course many more issues 93 hit new lows ; hit	the hitting of new lows by 93 was caused by many more issues
the value of the acquisition was n't disclosed ; disclosed	the disclosing of the value of the acquisition didn't happen
olivetti reportedly began shipping these tools in 1984 ; shipping	the shipping of these tools by olivetti began in 1984
but what about all those non-duck ducks flapping over washington ; flapping	the flapping of all those non duck ducks over washington is being questioned
i blew it mr. motley says apologetically ; blew	the blowing of it is done by mr. motley apologetically
the company 's president quit suddenly ; quit	the quitting of the company president occurred suddenly
a federal judge turned down the chapter 11 petition ; turned	the turning down of the chapter 11 petition was made by a federal judge
i blew it mr. motley says apologetically ; says	the saying of i blew it was something mr. motley did apologetically
this deal is like a roach motel he said ; said	saying this deal is like a roach motel was he
again no such statement appears on the tapes ; appears	the appearance again of no such statement is on the tapes
poland makes no machinery for a plant on that scale ; makes	making no machinery for a plant on that scale is poland
even drexel is pulling back ; pulling	the pulling back is by drexel
but markets can operate with greater or lesser efficiency ; operate	the operating of the markets can be with greater or less efficiency
that amounts to more than 350 billion a year ; amounts	the amounting to a year was more than 350 billion
you ca n't give it up that easily he says ; give	giving up that easily you cannot do, he says
and he has attached himself to the lincoln story tenaciously ; attached	the attaching of himself to the lincoln story was tenacious
aftershocks rattled northern california amid an earthquake cleanup ; rattled	the rattling of northern california by aftershocks occurred amid an earthquake cleanup
you ca n't give it up that easily he says ; says	saying you can not give it up that easily is he
bonuses would be paid based on playing time and performance ; paid	the payment of bonuses would be based on playing time and performance
but the strategy is n't helping much this time ; helping	the helping from the strategy is not much at this time
the company rejected those past proposals ; rejected	the rejecting of those past proposals comes from the company
murder threat charged in haas securities corp stock-manipulation trial ; charged	there was a charge in the haas securities corp stock-manipulation trial
bonuses would be paid based on playing time and performance ; based	the basis of playing time and performance is how bonuses would be paid
some however lowered yields significantly ; lowered	lowering yields significantly however were some
analysts expect further jitters this week ; expect	the expecting of further jitters is this week according to analysts
appalled mr. green never paid the money he testified ; paid	the paying of money never occurred according to the testimony by an appalled mr green
beyond that money managers and analysts see other problems ; see	seeing other problems beyond that money are managers and analysts
last week many jaguar shareholders took their money and ran ; took	the taking of money and running occurred last week by many jaguar shareholders
appalled mr. green never paid the money he testified ; testified	the testifying by an appalled mr green showed he never paid the money
lack of liquidity can also result from exchange reforms ; result	the result from exchange reforms can also be lack of liquidity
last week many jaguar shareholders took their money and ran ; ran	the running happened last week after many jaguar shareholders took their money
bankamerica 's profit jumped 34 % in the third quarter ; jumped	the jump of bankamerica's profit in the third quarter was 34%
revenue rose to 590.7 million from 575.1 million ; rose	the rising of the revenue went from 575.1 million to 590.7 million
some diaries simply are n't worth snooping in ; snooping	the snooping of some diaries simply is not worth it
it made my shoelaces dance with terror ; dance	the dancing of my shoelaces was caused by terror
commerzbank gained 1 to 252.5 ; gained	gaining 1 to 252.5 was commerzbank
not everything looks grim for quantum ; looks	looking grim for quantum is not everything
his melodious confutatis was smoothly sung by bass brian matthews ; sung	the singing of his melodious confutatis was done smoothly by bass brian matthews
they could still panic and bail out of the market ; panic	the panicking by them could still bail out the market
climate varies drastically due to natural causes said mr. thompson ; varies	varying drastically due to natural causes is climate said mr thompson
they could still panic and bail out of the market ; bail	the bailing out of the market could happen by them because of panic
hostile thus entered the merger-acquisition lexicon ; entered	the entering of the merger acquisition lexicon was by hostile
analysts said they expect mccaw to escalate the bidding again ; expect	the expecting of the bidding to escalate again by mccaw comes from analysts
analysts said they expect mccaw to escalate the bidding again ; escalate	the escalating of the bidding again by mccaw is expected according to analysts
borrowed shares on the amex rose to another record ; rose	rising to another record were borrowed shares on the amex
i do n't know where all the buses are ; know	knowledge of where all the buses are is something i don't have
he adds i think it was a fairly decent call ; adds	the addition that he made was that he thought it was a fairly decent call
when they halt trading all market liquidity is gone ; halt	the halt of trading happens and all market liquidity is gone
he adds i think it was a fairly decent call ; think	he adds my thinking is that it was a fairly decent call
when they halt trading all market liquidity is gone ; gone	gone is all market liquidity when they halt trading
but they have n't yet drawn the operational policy conclusions ; drawn	the drawing of the operational policy conclusions has not yet been done
it will continue to be sold in the european market ; continue	the continuing of the sale will be in the european market
genetic defect spotted in 3-day-old embryo ; spotted	the spotting of a genetic defect was in a 3 day old embryo
and i will never again complain about a rainout ; complain	the complaining about a rainout is something i will never do again
it will continue to be sold in the european market ; sold	the selling of it will continue in the european market
your paper needs a serious reality check ; needs	the need your paper has is for a serious reality check
now the firm says it 's at a turning point ; says	saying it is at a turning point is the firm now
making computers smaller often means sacrificing memory ; making	the making of computers smaller often means sacrificing memory
long-term treasury bonds ended slightly higher ; ended	the end of long-term treasury bonds was slightly higher
he also says he is losing money now ; losing	the losing of money he says is happening now
otherwise actual profit is compared with the 300-day estimate ; compared	the comparison of the 300 day estimate is done against the actual profit
making computers smaller often means sacrificing memory ; sacrificing	the sacrifice of memory happens when making computers smaller
radio programs and books have followed the daily television show ; followed	following the daily television show were radio programs and books
stocks of california-based thrifts also were hard hit ; hit	hit hard also were stocks of california based thrifts
asahi officials could n't be reached for comment ; reached	the reaching for comment could not be had by asahi officials
revenue rose 14 % to 4.03 billion from 3.54 billion ; rose	the rising of the revenue went from 14% to 4.03 billion from 3.54 billion
accord prices start at 12,345 ; start	starting at 12345 are accord prices
india 's gandhi called for parliamentary elections next month ; called	the calling by gandhi for parliamentary elections in india is for next month
over the next few years i would advise caution ; advise	advising caution over the next few years is what i would do
the french analysis goes further ; goes	the going further happens by french analysis
in europe the dollar ended lower in dull trading ; ended	the ending of the dollar in europe was lower due to dull trading
california prices were already coming down ; coming	the coming down of california prices was already happening
bankamerica 's total loans rose 8 % to 71.36 billion ; rose	the rising of total loans from 8 percent to 71.36 billion was for bankamerica
one team pays so much and the other pays more ; pays	the payment of one team is so much and the other team pays more
the contract settled at 1,014 a ton off 13 ; settled	the settling of the contract at 1014 was a ton off 13
and even though employees paid the bill taxpayers grumbled ; paid	even though the payment of the bill was made by the employees, the taxpayers grumbled
it ended with a gain of 88.12 points ; ended	the ending was a gain of 88.12 points
the dollar weakened against most other major currencies ; weakened	the weakening of the dollar was against most other major currencies
i wish he could wear lifts in his voice ; wish	the wish i have is that he could wear lifts in his voice
and even though employees paid the bill taxpayers grumbled ; grumbled	and the grumbling of taxpayers occurred even though employees paid the bill
the nasdaq financial index rose 2.09 to 454.86 ; rose	the rising of the nasdaq financial index went from 2.09 to 454.86
i wish he could wear lifts in his voice ; wear	the wearing of lifts in his voice is something i wish for
that is a property right that belongs to the performer ; belongs	the ownership of the property is for the performer
sales declined 3 % to 524.5 million from 539.4 million ; declined	the declining of sales was 3 percent from 539.4 million to 524.5 million
if nobody buys i bring my prices down ; bring	the bringing of my prices down happens if nobody buys
the transaction represents lynch 's entry into the telephone business ; represents	the representation of the transaction showed lynch's entry into the telephone business
general mills gained 2 1\/4 to 72 7\/8 ; gained	the gaining of general mills was 2 1v4 to 72 7v8
shorted shares must eventually be replaced through buying ; replaced	the replacement of the shorted shares must eventually be done through buying
most sleep on the floor ; sleep	the sleeping of most happens on the floor
the dow jones industrial average fell 26.23 points to 2662.91 ; fell	the falling of the dow jones industrial average went from 26.23 points to 2662.91
the results ca n't be extrapolated to all investors though ; extrapolated	the extrapolation of results can't apply to all investors though
last week cbs inc. canceled the people next door ; canceled	the canceling of the people next door last week was by cbs inc
people in the phone business call this technology 900 click ; call	the calling of this technology the 900 click is done by people in the phone business
but there did seem to be a retail activity pickup ; seem	the seeming of activity was from retail pickup
meanwhile competition from rivals unencumbered by history is intensifying ; intensifying	the intensifying of the competition from rivals is unencumbered by history
the people who tape the most buy the most ; tape	the taping is done the most by the people who buy the most
both issues are dated oct. 26 ; dated	dating oct 26 are both issues
the people who tape the most buy the most ; buy	the buying of the most is done by people who tape the most
brawls between union factions still erupt at pemex installations ; erupt	erupting brawls between union factions still occur at pemex installations.
they will have to throw their hat in the ring ; throw	the throwing of their hat in the ring is what they'll have to do
the company is being acquired ; being	the being acquired of the company is happening
this is how american women won the right to vote ; won	the winning of the right to vote was done by american women this way
supermarkets are getting into the variety act too ; getting	getting into the variety act too are supermarkets
the company is being acquired ; acquired	acquisition is what is happening to the company
he also reaffirmed east germany 's allegiance to communist orthodoxy ; reaffirmed	the reaffirming he made was of east germanys allegiance to communist orthodoxy
coca-cola co. may be about to intensify the cola wars ; intensify	the intensifying of the cola wars may be by coca cola co
sales rose to 52.4 million from 50.1 million ; rose	the rising of the sales went from 50.1 million to 52.4 million
per-share net rose to 62.04 yen from 51.50 yen ; rose	rising to 62.04 yen from 51.50 yen was per share net
neither disclosed details pending board meetings next month ; disclosed	the disclosure of details is something neither will do pending board meetings next month
most public-health measures were handled at the local level ; handled	the handling of most public-health measures was done at the local level
she made money but spent more ; made	the making of money did not stop her from spending more
she made money but spent more ; spent	the spending of more money came from her making more
more than 1,000 muscovites attended the service ; attended	the attendance of the service included more than 1,000 muscovites
they could all fairly be described as pap courses ; described	describing them all as pap courses could be fairly done
some of the oil interests already have been sold ; sold	the sale of some of the oil interests has already occurred
britain 's prime minister thatcher alone dissented ; dissented	the dissenting of britains prime minister thatcher was done alone
even lloyd 's specialty unusually risky ventures is being challenged ; challenged	the challenging of the unusually risky ventures is lloyd's specialty
tuesday the shares regained skr20 closing at skr225 ; regained	the regaining of shares on tuesday of skr20 closed at skr225
but the utility may not continue next year ; continue	the continuance of the utility next year may not happen
tuesday the shares regained skr20 closing at skr225 ; closing	closing at skr225 tuesday were the shares that regained skr20
the gruff financier recently started socializing in upper-class circles ; started	the start of socializing in upper-class circles was something the gruff financier recently did
the gruff financier recently started socializing in upper-class circles ; socializing	the socializing in upper class circles was recently started by the gruff financier
goldman sachs & co. will manage the offering ; manage	the managing of the offering will be done by goldman sachs & co
the incident occurred saturday night ; occurred	the occurring of the incident happened on saturday night
however inflation for 1990 was seen slowing to 4.5 % ; slowing	slowing to 4.5 % was seen for inflation for 1990 however
the wholesale price index stood at 89.6 1985 equals 100 ; equals	the equaling of 1985 to 100 comes from when the wholesale price index stood at 89.6
i 'm ashamed i own the stupid thing ; own	ownership of the stupid thing is something i'm ashamed of
officials at aristech based in pittsburgh declined comment ; declined	the declination of the comment was done by the officials at aristech based in pittsburgh
sekisui house which gained 150 tuesday lost 70 to 2640 ; gained	gaining 150 tuesday was sekisui house which lost 70 to 2640
on some days the nucor plant does n't produce anything ; produce	the producing of anything by nucor plant does not occur on some days
the reason does n't relate to your selling skills ; relate	the relation of the reason isn't to your selling skills
gaf faces potential fines of 500,000 for each count ; faces	the facing of potential fines for gaf is 500000 for each count
he succeeds paul j. montle 42 who will remain chairman ; succeeds	the succeeding of paul j montle 42 will allow him to remain chairman
but it never did let up on the pressure ; let	the letting up of the pressure on it never did happen
the company did n't put out a public announcement ; put	putting out a public announcement is what the company did not do
invariably he says eyewitnesses are untrustworthy ; says	saying eyewitnesses are untrustworthy is what he invariably does
mead gained 1 to 37 7\/8 ; gained	the gaining of mead was 1 to 37 7v8
it is scheduled for delivery in late 1991 ; scheduled	the scheduling for the delivery of it is in late 1991
the company paid five cents a share in april ; paid	the payment made by the company in april was five cents a share
yet another political scandal is racking japan ; racking	the racking of japan is due to yet another political scandal
having only a republican measure makes the task harder ; makes	the making of the task harder is done by having only a republican measure
the u.s.-japan security treaty can continue sort of ; continue	continuing is something the us japan security treaty can sort of do
bush administration officials say inflation is under control ; say	the saying that inflation is under control comes from the bush administration
the playoff series had riveted the 12-year-old giants fan ; riveted	the riveting of the 12 year old giants fan was due to the playoff series
he said the transaction was made for investment purposes ; said	the saying that the transaction was for investment purposes was made by him
the bakersfield supermarket went out of business last may ; went	going out of business last may was the bakersfield supermarket
he said the transaction was made for investment purposes ; made	he said the making of the transaction was for investment purposes
consumer stocks once again set the pace for blue-chip issues ; set	setting the pace for blue-chip issues once again were consumer stocks.
the offer is based on several conditions including obtaining financing ; based	the basing of the offer on several conditions includes obtaining financing
more elderly maintain their independence ; maintain	maintaining their independence were more elderly
the board has 10 business days to respond ; respond	the response of the board need come in 10 business days
the company earned 6.6 million in the year-earlier quarter ; earned	the earning of 6.6 million in the year earlier quarter happened to the company
the offer is based on several conditions including obtaining financing ; including	the inclusion of obtaining financing is one of several conditions on which the offer is based
cathay is taking several steps to bolster business ; taking	the taking of several steps to bolster business was done by cathay
kirschner medical fell 4 to 15 ; fell	the falling of 4 to 15 was by kirschner medical
cathay is taking several steps to bolster business ; bolster	the bolstering of the business is being done by cathy in several steps
traders said most municipal bonds ended 1\/2 point higher ; said	the saying that most municipal bonds ended 1v2 point higher came from traders
the offer is based on several conditions including obtaining financing ; obtaining	the obtainment of financing is one of several conditions upon which the offer is based
mr. shilling understands mr. straszheim 's problems ; understands	an understanding exists by mr. shilling of mr. strasheim's problems
he bites it scowls and throws it down ; bites	after the biting, it scowls and throws it down
he bites it scowls and throws it down ; scowls	the scowling happened after he bit it and before he threw it down
he bites it scowls and throws it down ; throws	throwing it down is what he does after he bites it and scowls
long-term care insurance gains favor ; gains	gaining favor is long term care insurance
tymnet is a major network linking computers ; linking	the linking of the computers is done by tymnet, a major network
the union though has called the offer insulting ; called	the calling of the offer insulting was done by the union
sumitomo realty & development rose 40 to 2170 ; rose	the rise of 40 to 2170 was by sumitomo realty & development
but investors do n't seem to think so ; seem	but seeming to think so is what investors do not do
americans did n't dislike metrics they simply ignored them ; ignored	the ignoring of metrics by americans was not because they disliked them
lack of important needed information can cause fear ; cause	causing fear is what lack of important needed information can do
couple counseling grows to defuse stress ; defuse	the defusing of stress is grown through couple counseling
to date scientists have fingered two of these cancer-suppressors ; fingered	fingering two of these cancer-suppressors has been done by scientists to date
cathay officials decline to comment on the speculation ; comment	commenting on the speculation is what cathay officials decline to do
mccaw 's offer is scheduled to expire tomorrow ; expire	expiring tomorrow is what mccaw 's offer is scheduled to do
german and dutch investors reportedly loaded up on kellogg co ; loaded	loading up on kellogg co was what german and dutch investors reportedly did
budget is set at 1.5 million ; set	the setting of the budget is at 1.5 million
but a bunch of utilities should post profit increases ; post	but the posting of profit increases is something a bunch of utilities should do
the current debt limit expires oct. 31 ; expires	the expiring of the current debt limit is on oct 31
apparently they are learning to say no to excess risk ; learning	learning to say no to excess risk is what they are apparently doing
but it fell to 1.8470 marks from 1.8485 ; fell	the falling of it was from 1.8485 to 1.8470 marks
our view is that we may see a profit decline ; see	seeing a profit decline is our view of what we may do
these errata do not affect business programs he said ; said	saying that these errata do not affect business programs is what he did
they always listened but they never acted mr. guber says ; listened	listening was something they always did but they never acted mr. guber says
he intends to add to the litigation staff ; add	adding to the litigation staff is what he intends to do
lloyd 's only recently reported its financial results for 1986 ; reported	reporting its financial results for 1986 is something lloyd 's only recently did
mr. stein was fined 25,000 and suspended for three years ; fined	the fining of 25000 was to mr stein who was also suspended for three years
the celtona operations would become part of those ventures ; become	becoming part of those ventures is what the celtona operations would do
sunbelt foreclosed on the ranch ; foreclosed	foreclosing on the ranch is what sunbelt did
they note that stocks experienced volatile swings long before futures ; note	noting that stocks experienced volatile swings long before futures is what they do
but investors looking for alternatives are n't finding it easy ; finding	the finding of alternatives has not been easy according to investors
some hotels in the hurricane-stricken caribbean promise money-back guarantees ; promise	the promising of money back guarantees was done by some hotels in the hurricane stricken caribbean
apparently they are learning to say no to excess risk ; say	saying no to excess risk is what they apparently are learning
we wanted them to build a road here he says ; says	saying we wanted them to build a road here is what he does
a spokesman cited a technical error and declined to elaborate ; elaborate	an elaboration opportunity was declined by a spokesman who cited a technical error
sales rose 8.4 % to 27.95 billion from 25.78 billion ; rose	rising 8.4 % to 27.95 billion from 25.78 billion were sales
mr. stein was fined 25,000 and suspended for three years ; suspended	the suspending of three years was done to mr stein who was also fined 25000
nissan will introduce a completely revamped sentra next fall ; revamped	the revamping of the sentra will be introduced by nissan next fall
but five weeks after the premiere the series has floundered ; floundered	the floundering of the series occurred five weeks after the premiere
mr pyszkiewicz smiles and his brow furrows ; furrows	furrowing his brow and smiling is what mr pyszkiewicz does
eavesdropping by individuals is harder to measure ; measure	measuring eavesdropping by individuals is harder to do
the panhandler approaches makes his pitch ; approaches	approaching the panhandler makes his pitch
after that the federal share diminishes ; diminishes	the diminishing of federal shares occurred after that
but junk bonds took more hits ; took	but taking more hits were junk bonds
an earthquake struck northern california killing more than 50 people ; struck	striking northern california killing more than 50 people was an earthquake
mine comes from seeing thriving communities devastated but only temporarily ; devastated	the devastating temporarily of thriving communities is what mine comes from seeing
corporations need liquidity in the form of borrowed funds ; need	the needing of liquidity in the form of borrowed funds comes from corporations
the case went on appeal to the second circuit ; went	having went on appeal to the second circuit was the case
the council plans to release its regional reports monthly ; plans	planning to release its regional reports monthly is the council
the nasdaq 100 rose 7.08 to 445.23 ; rose	the rising of the nasdaq was 7.08 to 445.23
the investors range from elderly widows to affluent professionals ; range	ranging from elderly widows to affluent professionals are the investors
but he warned the currency will remain at risk ; remain	the remaining of the risk he warned will be to currency
perhaps in time the supreme court will correct them ; correct	the correcting of them perhaps in time could be done by the supreme court
the offering is scheduled to expire on nov. 30 ; scheduled	the scheduling of the offering is to expire on nov 30
mr. decker 's resignation surprised many industry officials ; surprised	surprising many industry officials was what  mr. decker 's resignation did
mr. smith is trying hard to allay the anger ; allay	the allaying of the anger is something mr smith is trying hard to do
the selling that started on friday continued yesterday ; started	starting on friday was the selling that continued yesterday
but ms. mccraw says the magazine is fighting back ; says	saying but the magazine is fighting back is what ms mccraw does
ncnb 's profit more than doubled ; doubled	more than doubling was the profit of ncnb
james a. white and sonja steptoe contributed to this article ; contributed	the contribution to this article was by james a white and sonja steptoe
their opposition helped scare off some japanese banks ; scare	scaring off some japanese banks is what their opposition helped do
after cooling the coins are then rewrapped ; cooling	cooling of the coins takes place and they are then rewrapped after
i mean it is a normal adult relationship ; mean	the meaning of it is as a normal adult relationship
the session failed to enact any new curbs ; enact	enacting any new curbs is what the session failed to do
but even mr. boren defends congressional oversight ; defends	but defending congressional oversight is what even mr boren does
the dollar finished at its intraday highs ; finished	the finishing of the dollar was at its intraday highs
you do n't know which way to punch ; punch	the punching of which way is something you do not know
the soviets have a world-leading space program the guests noted ; noted	noting that the soviets have a world-leading space program is what the guests did
the london times said she had contravened protocol ; contravened	contravening protocol is what the london times said she had done
that 'll save us time and get people involved ; get	getting people involved and saving us time is what that will do
but mr. monsky sees much bigger changes ahead ; sees	the seeing of bigger changes ahead is done by mr monsky
they had to do it ; do	the doing of it was something required of them
banks may contribute more senior debt ; contribute	contributing more senior debt is what banks may do
blue chips led the march up in heavy trading ; led	leading the march up in heavy trading were blue chips
the insurance adjusters think differently ; think	the thinking differently comes from the insurance adjusters
the bill is expected to pass in congress next month ; expected	expecting to pass in congress next month is the bill
the plant was evacuated and workers sent home ; evacuated	the evacuating of the plant sent workers home
mine comes from seeing thriving communities devastated but only temporarily ; comes	the coming from seeing thriving communities devastated but only temporarily is mine
put these together and you get programs about rape ; put	the putting of these together will get you programs about rape
bids totaling 475 million were submitted ; totaling	the totaling of bids for 475 million were submitted
the rest were withdrawn for lack of acceptable bids ; withdrawn	the withdrawing by the rest were due to a lack of acceptable bids
the ontario supreme court overturned mr. blair 's decision ; overturned	overturning of mr. blair 's decision was done by the ontario supreme court
beatrice e. garcia in philadelphia contributed to this article ; contributed	contributing to this article was beatrice e. garcia in philadelphia
please submit your offers says felipe bince jr ; submit	the submitting of your offers is requested by felipe bince jr
anti-nuclear activists took a less positive view ; took	taking a less positive view is what anti-nuclear activists did
apparently however the improvement came too late ; came	the coming of the improvement however was apparently too late
meanwhile at home mitsubishi has control of some major projects ; control	the controlling of some major projects happens meanwhile at home by mitsubishi
sir richard succeeds john plastow who resigned in july ; succeeds	the succeeding of sir richard is from john plastow who resigned in july
how many shares will be around in 1995 he asked ; asked	the asking of how many shares will be around in 1995 came from him
japanese department stores are also wary of attracting negative publicity ; attracting	attracting negative publicity is what japanese department stores are also wary of doing
the computers will display stock prices selected by users ; display	displaying of stock prices selected by users will be done by the computers
peter gumbel in moscow contributed to this article ; contributed	contribution to this article was done by peter gumbel in moscow
some are even coming up with their own novel designs ; coming	the coming up with their own novel designs is being done by some
she said a more aggressive move was n't needed ; needed	she said the need for a more aggressive move didn't happen
since then she has become wealthy ; become	becoming wealthy is what she has done since then
officials at carnival declined to comment ; declined	the declining to comment came from the officials at carnival
the antibody then kills the cell ; kills	killing the cell is what the antibody then does
the predictions of doom are premature she says ; says	saying the predictions of doom are premature is what she does
it now takes something really weird to inspire public outrage ; takes	taking something really weird is what it now does to inspire public outrage
mr. baker promises to return if the haunting continues ; return	returning if the haunting continues is what mr. baker promises to do
cincinnati bell inc. said net declined 1.8 % ; declined	declining 1.8 % was what net did cincinnati bell inc. said
what the arabs started inflation finished ; started	the starting of it by the arabs was finished by inflation
some have raised their cash positions to record levels ; raised	raising their cash positions to record levels is what some have done
they effectively lead team efforts to reduce cycle time ; reduce	the reducing of the cycle time was effectively lead by team efforts
mr. smith is trying hard to allay the anger ; trying	the trying to allay the anger is done hard by mr smith
buy stocks on weakness for their long-term fundamentals he says ; says	saying buy stocks on weakness for their long-term fundamentals is what he does
mccaw 's offer is scheduled to expire tomorrow ; scheduled	scheduled to expire tomorrow is mccaw 's offer.
david b. hilder in new york contributed to this article ; contributed	the contribution of this article was made by david b hilder in new york
proceeds from the offering are about 160.4 million ; offering	the offering from the proceeds is about 160.4 million
mr. rey made 50 million swiss francs on the sale ; made	making 50 million swiss francs on the sale was mr rey
but stunning volatility was produced in the process ; produced	the producing of stunning volatility was done during the process
conservatives shoot their own he says ; says	the saying that conservatives shoot their own comes from him
proceeds will be used to eliminate and restructure bank debt ; restructure	restructuring bank debt and eliminating it is what proceeds will be used to do
many economists expect the weakness to continue ; continue	continuing is what many economists expect the weakness to do
the suit seeks unspecified damages ; seeks	the seeking of unspecified damages comes from the suit
the bill is expected to pass in congress next month ; pass	the passing of the bill in congress is expected to happen next month
revenue rose 3 % to 9 million from 8.8 million ; rose	the rising of revenue was 3 percent from 8.8 million to 9 million
the dow jones industrials closed at 2569.26 ; closed	closing at 2569.26 were the dow jones industrials
his dismissal triggered a furor among intellectuals that continues today ; continues	the continuation today of a furor among intellectuals was triggered by his dismissal
revenue rose 27 % to 715.1 million from 563.8 million ; rose	rising 27 % to 715.1 million from 563.8 million was what revenue did
for cathay pacific airways the smooth ride may be ending ; ending	ending is what the smooth ride for cathay pacific airways may be doing
they want to do more ; want	wanting to do more is what they are doing
stock prices finished about unchanged friday in quiet expiration trading ; finished	the finishing of stock prices was unchanged friday in quiet expiration trading
in last week 's house vote 41 republicans defected ; defected	defection in last week 's house vote was done by 41 republicans
it 's just not cost efficient he says ; says	the saying that it is just not cost efficient came from him
known as easy eggs the product has disappointed investors ; disappointed	the disappointment of investors has been caused by the product known as easy eggs
i think you have to give greenspan a good rating ; think	the thinking i have of greenspan is to give it a good rating
wall street is n't avoiding everything connected with paper ; connected	the connecting of everything to paper is not something wall street is avoiding
that 's just what joseph granville expects ; expects	expecting just that is what joseph granville is doing
california a trend-setter in franchising rules stirs a controversy ; stirs	the stirring of a controversy is due to franchising rules from california a trend setter
litigation sciences does n't make moral distinctions ; make	making moral distinctions is what litigation sciences does not do
the company plans to be fully operational today ; plans	the planning by the company is to be fully operational today
he said the normal ratio is five to six weeks ; said	saying that the normal ratio is five to six weeks is what he did
compuserve provides about 20 % of both sales and earnings ; provides	the providing of about 20 percent of both sales and earnings comes from compuserve
in these circumstances i think they 'd win ; think	thinking they would win is what i do in these circumstances
she thought i was n't getting my practicing done ; getting	getting my practicing done was something she thought i was not doing
it was like a play on broadway recalls mr. martinez ; recalls	recalling that it was like a play on broadway is what mr. martinez does
the two sides had n't met since oct. 18 ; met	the meeting of the two sides has not occurred since oct 18
imports of goods and services soared while exports were flat ; soared	soaring while exports were flat were imports of goods and services
however for many managing speed does not come naturally ; come	coming naturally is however for many what managing speed does not do
he describes a drowned corpse as esther williams ; describes	the describing of the drowned corpse he likened to esther williams
how can we turn this situation around ; turn	the turning around of this situation is something we question
it 's too disruptive he says ; says	saying it 's too disruptive is what he does
anne does n't believe in blandness said ms. smith ; believe	believing in blandness is something anne does not do said ms smith
mr. allday would succeed martha hesse who is resigning ; succeed	the succeeding of mr allday would come as martha hesse is resigning
of course mr. mason did not use neutral language ; use	using neutral language is of course what mr mason did not do
crane dropped 1 1\/8 to 21 1\/8 ; dropped	dropping 1 1\/8 to 21 1\/8 is what crane did
paper work on how it was spent is incomplete ; spent	the spending of it on paperwork is incomplete
cincinnati microwave inc. said it introduced two radar detectors ; said	saying it introduced two radar detectors was cincinnati microwave inc
sales gained 16 % to 1.03 billion from 894 million ; gained	gaining 16 % to 1.03 billion from 894 million were sales
but then it was acquired by household international inc ; acquired	but acquisition by household international inc then happened to it
kyocera advanced 80 yen to 5,440 ; advanced	the advancing of kyocera was 80 yen to 5440
american home products corp. proposes to acquire the company ; acquire	the acquiring of the company was proposed by american home products corp
he intends to add to the litigation staff ; intends	intending to add to the litigation staff is what he does
california enacted a rights law in 1988 ; enacted	enacting of a rights law in 1988 is what california did
american home products corp. proposes to acquire the company ; proposes	proposing to acquire the company is what american home products corp does
occasionally all that 's needed is a little coaxing ; coaxing	a little coaxing is occasionally all that is needed
is this what the home builders want ; want	the wanting of this could be by home builders
just say the offices are tastefully appointed he says ; says	saying just say the offices are tastefully appointed is what he does
they always listened but they never acted mr. guber says ; says	saying they always listened but they never acted is what  mr. guber does
the company has been manufacturing carpet since 1967 ; manufacturing	manufacturing carpet since 1967 is what the company has been doing
tom herman contributed to this article ; contributed	contributing to this article was tom herman
measures of manufacturing activity fell more than the overall measures ; fell	the fall of measures of manufacturing activity was greater than the overall measures
prices peaked at 1,150,000 in september 1987 ; peaked	peaking at 1,150,000 in september 1987 is what prices did
the offer made june 1 has been extended several times ; extended	extending several times is what the offer made june 1 has been doing
many bankers view property-sector loans as particularly risky ; view	viewing property-sector loans as particularly risky is what many bankers do
himont quantum and union carbide all declined to comment ; comment	commenting is what himont quantum and union carbide all declined to do
i find it very difficult to say that ; find	finding it very difficult to say that is what i am doing
but investors do n't seem to think so ; think	but thinking so is what investors do not seem to do
the company 's sales flattened during 1989 's first half ; flattened	flattening during 1989 's first half is what sales of the company did
there 's some price at which we 'd stop bidding ; stop	the stopping price exists at which we would would stop bidding
nasdaq 's gain was led by its biggest industrial stocks ; led	leading by its biggest industrial stocks was what nasdaq 's gain did
call it the we 're too broke to fight defense ; fight	the fighting of the defense because we are too broke is what we should call it
not everyone has jumped on the breeden bandwagon however ; jumped	jumping on the breeden bandwagon however is not what everyone has done
trading activity cooled off from monday 's sizzling pace ; cooled	the cooling of the trading activity was off from mondays sizzling pace
but under alan greenspan that has changed ; changed	but changing is what that has done under alan greenspan
it implies very dramatic growth he said ; implies	implying very dramatic growth is what it does he said
the dax dropped 19.69 points friday to 1462.93 ; dropped	dropping 19.69 points friday to 1462.93 was the dax
noriega managed the whole thing ; managed	the managing of the whole thing was done by noriega
the media she says have distorted his personal life ; distorted	distorting his personal life is what the media have done she says
esselte business systems rose 1 to 43 1\/2 ; rose	the rising of 1 to 43 1v2 was by esselte business systems
the transaction would mark the entry of p&g into cosmetics ; mark	marking the entry of p&g into cosmetics is what the transaction would do
when selling is so frenzied prices fall steeply and fast ; fall	the fall of prices steeply and fast happens when selling is so frenzied
please submit your offers says felipe bince jr ; says	saying please submit your offers is what felipe bince jr does
i do n't talk about my work he says ; says	saying i do n't talk about my work is what he does
that contract was tied to the success of the buy-out ; tied	the tying of the contract is to the success of the buy out
it is known in the pentagon as the negative wedge ; known	the knowing of it in the pentagon is as the negative wedge
still time 's move is being received well once again ; being	being received well once again is time's move still
proceeds from those sales will be used to reduce debt ; reduce	reduction of debt is what proceeds from those sales will be used for
mr pyszkiewicz smiles and his brow furrows ; smiles	smiling is what mr pyszkiewicz does and his brow furrows
you can think long range ; think	having thought that's long range is something you can do
terms include a royalty arrangement but details were n't disclosed ; disclosed	disclosing details was not done but terms include a royalty arrangement
i wish them all the best ; wish	wishing them all the best is what i do
if so the damages could be tripled ; tripled	the tripling of the damages could occur
the drug was introduced in west germany this year ; introduced	introduced in west germany this year was the drug
terms include a royalty arrangement but details were n't disclosed ; include	the including of a royalty arrangement was in the terms but details were not disclosed
working with lawyers she says i need it ; need	the needing of it is conveyed by her through working with lawyers
britain 's unsettled political scene also worries some investors ; worries	also worrying some investors is what britain 's unsettled political scene is doing
penalty overhaul is still likely congressional sources say ; say	saying that penalty overhaul is still likely is what congressional sources are doing
south african gold stocks ended marginally firmer ; ended	ending marginally firmer were south african gold stocks
the computers will display stock prices selected by users ; selected	the selecting of stock prices by users will be displayed by the computers
similar proposals were defeated in at least 15 other states ; defeated	the defeating of similar proposals occurred in at least 15 other states
couple counseling grows to defuse stress ; grows	growing to defuse stress is what couple counseling is doing
corporations need liquidity in the form of borrowed funds ; borrowed	the borrowing of funds in that form is needed by corporations for liquidity
still there is money to be made ; made	making of money is still there
mr. sukle says he would n't dream of participating himself ; says	saying he would n't dream of participating himself is what mr sukle does
the scars will be here years after the polls close ; close	the closing of the polls will not affect the scars that will be here for years after
it implies very dramatic growth he said ; said	the saying that it implies very dramatic growth came from him
afterwards i went home and practiced for three hours ; went	the going home afterwards was when i practiced for three hours
he speaks only in filipino ; speaks	speaking only in filipino is what he does
like lebanon israel is being remade by demography ; remade	the remaking of israel by demography is like lebanon
that may be the last thing she needs ; needs	needing that may be the last thing she does
the delicious hegemony wo n't end anytime soon ; end	the ending of the delicious hegemony will not be anytime soon
take your vacation in a hurricane area ; take	the taking of a vacation is in a hurricane area
he explains that companies with real estate give security ; explains	explaining that companies with real estate give security was he
they were absolutely killed slaughtered said one chicago-based options trader ; said	the saying that they were killed slaughtered came from one chicago based options trader
he became angry in return ; became	becoming angry in return was what he did
other companies figure they ca n't avoid the market ; avoid	the avoiding of the market is something other companies figure they cannot do
there 's no finger to be pointed she said ; pointed	the pointing of a finger is not to be done she said
we ca n't do without their help says mrs. conradie ; do	doing without their help is what we cannot do says mrs. conradie
craig forman in london contributed to this article ; contributed	contributing to this article was craig forman in london
estimated and actual results involving losses are omitted ; estimated	the estimating and actual results involving losses are omitted
revenue rose 15 % to 2.17 billion from 1.89 billion ; rose	rising 15 % to 2.17 billion from 1.89 billion was revenue
my position is well-known and well-stated he replied ; replied	replying my position is well-known and well-stated is what he did
that 's ok mr. sagan replies ; replies	the replying of it being ok comes from mr sagan
they talked of the home run ; talked	talking of the home run is what they did
but they think promotions are limited ; think	but thinking promotions are limited is what they do
others prefer deep-discount zero-coupon bonds ; prefer	preferring deep-discount zero-coupon bonds were others
mr. friend says his side is dead serious ; says	saying that his side is dead serious was mr friend
but so-called outer month contracts finished higher ; finished	the finishing of the so called outer month contracts was higher
several projects he said are still on the drawing board ; said	saying that several projects are still on the drawing board is what he did
integrated made its announcement after the market closed ; made	the making of the announcement came from integrated after the market closed
artists and draftsmen need harder leads ; need	needing harder leads are artists and draftsmen
some companies including heinz even pay part of the fee ; pay	paying part of the fee is what some companies including heinz even do
reluctant advertisers try soft-sell spots ; try	the trying of soft cell spots is done by reluctant advertisers
proceeds will be used to eliminate and restructure bank debt ; eliminate	eliminating and restructuring bank debt is what proceeds will be used to do
mervin lung remains chairman and chief executive officer ; remains	remaining as chairman and chief executive officer is mervin lung
revenue climbed 4.3 % to 14.31 billion from 13.71 billion ; climbed	climbing 4.3 % to 14.31 billion from 13.71 billion is what revenue did
we 've got a lot to do he acknowledged ; acknowledged	acknowledging that we have got a lot to do is what he did
the price was n't disclosed ; disclosed	disclosing of the price was not done
polymerix makes lumber-like materials that it describes as plastic wood ; makes	making lumber-like materials that it describes as plastic wood is what polymerix does
a 60-day to 65-day supply is considered normal ; considered	considered as normal is what a 60-day to 65-day supply is
prudential insurance is based in newark n.j ; based	the basing in newark nj is by prudential insurance
the japanese take the long view said mr. veronis ; said	saying the japanese take the long view was mr veronis
remember the dalkon shield and the early birth-control pills ; remember	remembering of the dalkon shield and the early birth-control pills
and in some neighborhoods rents have merely hit a plateau ; hit	and hitting a plateau is what rents in some neighborhoods have merely done
shortage and crisis became buzz words although neither really applied ; applied	the applying of shortage and crisis as buzz words never really occurred
the resignation came as a great surprise ; came	coming as a great surprise was the resignation
mr. noriega was growing desperate ; growing	the growth of desperation was something mr. noriega experienced
what the arabs started inflation finished ; finished	finishing what the arabs started is what inflation did
the shift wo n't affect operations ; affect	the affect of operations will not happen by the shift
capital associates dropped 1 to 5 3\/8 ; dropped	dropping 1 to 5 3\/8 was capital associates
how deeply do they read it ; read	the reading of how deeply it is is questioned
ual finished at 170 off 8 3\/8 ; finished	finishing at 170 off 8 3\/8 was ual
the dow jones industrials gained 4.92 to 2643.65 ; gained	gaining 4.92 to 2643.65 were the dow jones industrials
cincinnati microwave inc. said it introduced two radar detectors ; introduced	the introduction of two radar detectors was something cincinnati microwave inc. said it did
it 's good exercise he says ; says	saying it 's good exercise is what he does
nashua announced the reiss request after the market closed ; announced	the announcing of the reiss request came from nashua after the market closed
i 've surrendered to the circumstances mr. fedders says ; says	saying i 've surrendered to the circumstances is what mr. fedders does
the real tragedies occurred elsewhere as we soon found out ; occurred	occurring elsewhere as we soon found out were the real tragedies
the council plans to release its regional reports monthly ; release	the releasing of its regional reports has been planned monthly by the council
seats currently are quoted at 410,000 bid 425,000 asked ; quoted	the quoting of current seats at 410000 are asked to bid at 425000
both philip morris and backer spielvogel declined to comment ; declined	the declining to comment came from both philip morris and backer spielvogel
starting tomorrow i 'm stalking you ; stalking	stalking you is what i am doing starting tomorrow
usx is funneling drilling pipe to steel-hungry soviet union ; funneling	funneling drilling pipe to steel-hungry soviet union is what usx is doing
whittle has met some resistance ; met	meeting some resistance is what whittle has done
another challenges merrill lynch 's bond recommendation last year ; challenges	the challenging by another to merrill lynchs bond recommendation happened last year
unless the questions are answered i will keep on going ; keep	keeping on going unless the questions are answered is what i will do
likewise no government will stop this idea of the afrikaners ; stop	stopping of this idea of the afrikaners is likewise what no government will do
the work though sounds like muzak for spaceships ; sounds	sounding like muzak for spaceships is what the work does
but on oct. 6 he had reason to celebrate ; celebrate	but celebrating is something he had reason to do on oct 6
buy stocks on weakness for their long-term fundamentals he says ; buy	the buying of stocks he said was on weakness for their long term fundamentals
they 're getting some major wins she added ; getting	getting some major wins is what they are doing she added
in fact they seemed a mite resentful ; seemed	seeming a mite resentful is in fact what they did
but it was the underlying situation that became intolerable ; became	but becoming intolerable is what the underlying situation was doing
officials there declined to comment as did helmsley management ; declined	the declining to comment came from both helmsley management and official there
i could n't afford to hire 16 whites ; hire	the hiring of 16 whites is something i could not afford
the cia told him it does not do domestic counterespionage ; told	telling him it does not do domestic counterespionage was the cia
tokyu construction gained 170 to 1610 ; gained	the gaining of 170 to 1610 was to tokyo construction
nekoosa also is being advised by goldman sachs & co ; being	being advised by goldman sachs & co is what nekoosa is also doing
essentially the critics of stock-index futures fall into two camps ; fall	falling into two camps are essentially the critics of stock-index futures
we certainly see an increasing trend toward that she added ; see	seeing an increasing trend toward that is what we certainly are doing she added
but investors looking for alternatives are n't finding it easy ; looking	the looking for alternatives by investors has not been easily found
working with lawyers she says i need it ; says	saying that working with lawyers i need it is what she does
i do n't talk about my work he says ; talk	talking about my work is something he says i don't do
they both called it a welcome home gathering ; called	calling it a welcome home gathering is what they both did
the japanese take the long view said mr. veronis ; take	taking the long view is what the japanese do said mr veronis
mr. ahmad 's lawyer said he would appeal ; appeal	appealing is what mr. ahmad 's lawyer said he would do
he also leads an opulent life style ; leads	leading an opulent life style is what he also does
revenues rose 8.8 % to 4.35 billion from 4.0 billion ; rose	rising 8.8 % to 4.35 billion from 4.0 billion is what revenues did
the gene thus can prevent a plant from fertilizing itself ; prevent	preventing a plant from fertilizing itself is thus what the gene can do
jeff rowe contributed to this article ; contributed	contributing to this article was done by jeff rowe
maybe they learned from experience ; learned	learning from experience is maybe what they did
she said a more aggressive move was n't needed ; said	saying that a more aggressive move was n't needed is what she did
dell computer dropped 7\/8 to 6 ; dropped	the dropping of dell computer was 7v8 to 6
veiling his message has helped him endure ; veiling	veiling of his message is what has helped him endure
it 's better to wait ; wait	waiting is what it is better to do
three companies began trading over the counter ; trading	the trading over the counter began by three companies
but critics consider the changes regressive ; consider	the considering of the changes to be regressive is done by critics
three companies began trading over the counter ; began	beginning of trading over the counter was done by three companies
what could imply more safety than investing in government bonds ; investing	the investing in government bonds is what implies more safety
i thought your editorial was factually accurate and deliberately elucidative ; thought	thinking your editorial was factually accurate and deliberately elucidative was what i did
the association said domestic demand grew 8.8 % in september ; grew	growing 8.8 % in september was domestic demand the association said
estimated and actual results involving losses are omitted ; omitted	omission is what is done to estimated and actual results involving losses
competitors are known as the enemy ; known	known as the enemy are competitors
the selling that started on friday continued yesterday ; continued	continuing yesterday was the selling that started on friday
the dollar also moved higher in tokyo ; moved	moving higher in tokyo is also what the dollar did
that is a little disturbing ms. kleinman said ; said	saying that is a little disturbing was ms kleinman
mr. glazer could n't immediately be reached to comment ; comment	commenting is what mr. glazer could n't immediately be reached to do
the japanese government does n't allow this ; allow	the allowing of this isn't something that the japanese government does
just say the offices are tastefully appointed he says ; say	saying the offices are tastefully appointed is just what to do he says
warehouse productivity is really beginning to take off ; beginning	the beginning of the take off is due to warehouse productivity
mine comes from seeing thriving communities devastated but only temporarily ; seeing	seeing thriving communities devastated but only temporarily is where mine comes from
some in arizona think that may be optimistic ; think	thinking that may be optimistic is what some in arizona are doing
mr. maynard claims this is a manageable problem ; claims	claiming that this is a manageable problem is what mr maynard does
many law firms sponsor their own programs ; sponsor	sponsorship of their own programs is done by many law firms
it 's bad soil he says ; says	saying it is bad soil is what he does
japanese government bonds showed little change ; showed	showing little change were japanese government bonds
i would like to have had them he said ; like	liking having had them is something i would do he said
he sees a psychoanalyst five mornings a week ; sees	the seeing of a psychoanalyst is done by him five mornings a week
his dismissal triggered a furor among intellectuals that continues today ; triggered	triggering a furor among intellectuals that continues today is what his dismissal did
we certainly see an increasing trend toward that she added ; added	the addition she made was that we certainly see an increasing trend toward that
usair fell 2 1\/2 to 40 ; fell	falling 2 1\/2 to 40 was usair
he explains that companies with real estate give security ; give	giving security he explains is what companies with real estate do
officials there declined to comment as did helmsley management ; comment	commenting is what officials there declined as did helmsley management to do
health clubs gear up for a graying clientele ; gear	gearing up for a graying clientele is what health clubs are doing
the senators responded in kind ; responded	the response from the senators was in kind
friday brings the final count on october auto sales ; brings	bringing the final count on october auto sales is friday
the association said domestic demand grew 8.8 % in september ; said	the saying that the domestic demand grew 8.8 percent in september came from the association
christmas shoppers find a helping hand from some catalog companies ; find	finding a helping hand from some catalog companies is what christmas shoppers are doing
but pfizer inc. based in new york reported flat earnings ; reported	reporting flat earnings is what pfizer inc. based in new york did however
americans did n't dislike metrics they simply ignored them ; dislike	the disliking of metrics by americans did not occur as they simply ignored them
more venturesome businesses are applying their skills in commercial fields ; applying	applying their skills in commercial fields is what more venturesome businesses are doing
he sits down at the piano and plays ; sits	sitting down at the piano and playing is what he does
mr. sukle says he would n't dream of participating himself ; participating	participating himself is something mr. sukle says he would not dream of
the failed bank had assets of about 129.6 million ; failed	the failing of the bank included assets of about 129.6 million
in these circumstances i think they 'd win ; win	winning is what i think they would do in these circumstances
then he unleashed his own unstoppable attack ; unleashed	unleashing his own unstoppable attack was what he then did
but the u.s. companies are redoubling their efforts ; redoubling	but the redoubling of efforts is done by the u.s. companies
the comparable year-earlier number was 56 million a spokesman said ; said	the saying that the comparable year earlier number was 56 million was made by a spokesman
sales rose 2.6 % to 1.32 billion from 1.29 billion ; rose	the rise in sales of 2.6% was from 1.29 billion to 1.32 billion
dwg is a holding company controlled by mr. posner ; controlled	controlling of the holding company dwg is done by mr posner
it now takes something really weird to inspire public outrage ; inspire	inspiring public outrage now takes something really weird to do
they saw an opportunity created by the sell-off ; created	the creating of the sell off occurred when they saw an opportunity
we ca n't do without their help says mrs. conradie ; says	saying we can not do without their help is mrs conradie
fanuc gained 100 to 7,580 ; gained	the gaining of 100 to 7580 came from fanuc
they note that stocks experienced volatile swings long before futures ; experienced	the experiencing of volatile swings they noted happened to stocks long before futures
i still say do n't look down ; say	saying do not look down is what i still do
advancing otc stocks outpaced decliners by 1,120 to 806 ; outpaced	outpacing decliners by 1120 to 806 were advancing otc stocks
she thought i was n't getting my practicing done ; thought	thinking that i was n't getting my practicing done is what she did
conservatives shoot their own he says ; shoot	shooting their own is what he says conservatives do
white children empty the wastepaper baskets and squeegee the windows ; empty	the emptying of the wastepaper baskets is done by white children who also squeegee the windows
dick darman call your office ; call	the calling to your office was by dick darman
the treasury 's benchmark 30-year rose fractionally ; rose	rising fractionally is what the treasury 's benchmark 30-year did
it 's that we do n't want to ; want	wanting to is what we do not do
like many sports buffs mr. engelken has turned cynic ; turned	turning cynic is what mr. engelken like many sports buffs has done
the cia told him it does not do domestic counterespionage ; do	doing domestic counterespionage is what the cia told him it does not do
and prosecutors declined to comment ; comment	commenting is what prosecutors declined to do
the plant was evacuated and workers sent home ; sent	the sending home of workers was due to the plant being evacuated
bally officials decline to discuss the situation ; discuss	discussion of the situation is declined by bally officials
and the egg producers have done a pretty good job ; done	and doing a pretty good job were the egg producers
i would like to have had them he said ; said	the statement he made was i would like to have had them
bally officials decline to discuss the situation ; decline	declining to discuss the situation were bally officials
the second portion will be completed the following year ; completed	completion the following year is what will happen to the second portion
but reform has n't taken hold yet ; taken	but taking hold is what the reform has not done yet
consider adopting your spouse 's name ; adopting	adopting your spouse 's name is what you should consider
it just is n't done ; done	doing it just is not done
the session failed to enact any new curbs ; failed	failing to enact any new curbs is what the session did
manufacturers too are stretching further to lure buyers ; lure	luring buyers is what manufacturers too are stretching further to do
the house just settled right down into the ground ; settled	settling right down into the ground is what the house just did
we wanted them to build a road here he says ; build	the building of a road is what we wanted here he says
they showed up but did n't or could n't challenge ; challenge	the challenging did not and could not happen despite that they showed up
the 6 3\/4 % notes yield 6.25 % ; yield	yielding 6.25 % are the 6 3\/4 % notes
either way the ghostbusting business is going like gangbusters ; going	going like gangbusters is either way what the ghostbusting business is doing
like lebanon israel is being remade by demography ; being	the being remade of israel by demography is like lebanon
and many have done just that ; done	and doing just that is what many have done
terms of the transaction were n't disclosed ; disclosed	the disclosing of the terms of the transaction did not occur
still time 's move is being received well once again ; received	the receiving well of times move is happening once again
the lobby says no again ; says	saying no again is what the lobby is doing
everybody was afraid of him mr. ingersoll says ; says	saying everybody was afraid of him is what mr. ingersoll does
the offering is scheduled to expire on nov. 30 ; expire	the expiring of the offering is scheduled for nov 30
sales rose slightly to 2.68 billion from 2.66 billion ; rose	rising slightly to 2.68 billion from 2.66 billion were sales
officials at carnival declined to comment ; comment	commenting is what officials at carnival declined to do
the interview did not touch on singapore 's domestic affairs ; touch	touching on singapore 's domestic affairs is something the interview did not do
ortega had threatened to end a 19-month-old ceasefire ; end	.ending a 19-month-old ceasefire is what ortega had threatened to do
revenue slipped 4.6 % to 835 million from 876 million ; slipped	slipping 4.6 % to 835 million from 876 million was revenue
a closing date has n't been set ; set	setting of a closing date has not been done
the loan to umno was made in september 1983 ; made	making of the loan to umno was done in september 1983
senate hears final arguments in impeachment trial of federal judge ; hears	the hearing of final arguments in the senate is for the impeachment trial of a federal judge
that compares with 3.5 % butterfat for whole milk ; compares	comparing with 3.5 % butterfat for whole milk is that
people start their own businesses for many reasons ; start	starting their own businesses is what people are doing for many reasons
it liquefies in a patchwork quilt pattern ; liquefies	liquefying in a patchwork quilt pattern is what it does
housing developers try brand-name buildings ; try	trying brand name buildings is what housing developers do
additional cable partners could boost subscribers even further ; boost	boosting subscribers even further is what additional cable partners could do
they want late-night shuttles to the biology labs ; want	wanting late-night shuttles to the biology labs is what they do
he seems to be typical of many professional money managers ; seems	seeming to be typical of many professional money managers is what he is
mr. edelson could n't be reached for comment ; reached	reaching mr edelson for comment is what could not be done
other money managers also opened their wallets ; opened	opening their wallets is what other money managers also did
mr. dozen knows these problems firsthand ; knows	knowledge of these problems firsthand is something mr. dozen has
i was in the berkeley main library when it hit ; hit	the hitting of it occurred when i was in the berkeley main library
clients include miller brewing co. and general motors ; include	the including of miller brewing co and general motors are as clients
the company estimates its total debt at about 5.2 billion ; estimates	the estimating of its total debt at about 5.2 million is done by the company
unless the questions are answered i will keep on going ; going	going is what i will keep on doing unless the questions are answered
warehouse productivity is really beginning to take off ; take	taking off is what warehouse productivity is really beginning to do
the fundamentals do n't change in an hour he says ; change	changing in an hour is what the fundamentals do not do he says
copper prices fell sharply friday afternoon ; fell	falling sharply friday afternoon were copper prices
he and mr. roderick were even dining out together ; dining	the dining out together was by mr roderick and him
veiling his message has helped him endure ; endure	enduring is what veiling his message has helped him do
some other fare promotions have backfired ; backfired	backfiring is what some other fare promotions have done
the work was done properly he said ; said	the saying that the work was done properly came from him
he 's running for governor ; running	running for governor was he
chief executives and presidents had come and gone ; come	coming and going is what chief executives and presidents had done
sotheby 's has been aggressively promoting the dorrance sale ; promoting	the promoting of the dorrance sale has been done aggressively by sothebys
that has outraged some fans ; outraged	outraging some fans is what that has done
a spokesman cited a technical error and declined to elaborate ; cited	citing a technical error was a spokesman who declined to elaborate
i 'm talking about landing in a canal ; talking	talking about landing in a canal is what i am doing
that will spur tandem 's growth ; spur	spurring tandem 's growth is what that will do
shrubs and flowers give it a pleasing and non-fortress-like appearance ; give	giving it a pleasing and non-fortress-like appearance is what shrubs and flowers do
the index fell 109.85 monday ; fell	falling 109.85 monday is what the index did
we 've got a lot to do he acknowledged ; do	doing a lot is what we have got to do he acknowledged
we do n't need the cash ; need	the needing of cash is not by us
they saw an opportunity created by the sell-off ; saw	seeing an opportunity created by the sell-off is what they did
a disastrous farce in malaysia screamed the manchester guardian ; screamed	the screaming of a disastrous farce in malaysia was done by the manchester guardian
the takeover mania also adds to volatility ; adds	the adding of volatility is caused by the takeover mania
terms on both deals were n't disclosed ; disclosed	disclosing of terms on both deals was not done
the farmer at the next truck shouts wheat ; shouts	the shouting of wheat is done by the farmer at the next truck
other mutual fund companies reported even lighter withdrawal requests ; reported	the reporting of even lighter withdrawal requests came from other mutual fund companies
integrated made its announcement after the market closed ; closed	the closing of the market is when integrated made its announcement
and ad agencies insist that they do ; insist	and insisting that they do are ad agencies
the earnings drop had been expected ; expected	the expecting was for the earnings drop
you have to be born with it ; born	the birthing of you is when it should be acquired
mr. glazer could n't immediately be reached to comment ; reached	the reaching of mr. glazer for comment couldn't be done immediately
sales rose 50 % to 2.1 billion from 1.4 billion ; rose	the rising of sales of 50 percent was 1.4 billion to 2.1 billion
that division 's manager has been fired ; fired	the firing of the manager was from that division
bids totaling 475 million were submitted ; submitted	the submission was of bids totaling 475 million
the value of the transaction was n't disclosed ; disclosed	disclosure of the value of the transaction was not done
it 's hard to know if people are responding truthfully ; responding	a response that's truthful is something that's hard to know if people are giving
medstone international plummeted 3 1\/4 to 7 1\/4 ; plummeted	plummeting 3 1\/4 to 7 1\/4 was medstone international
they want to do more ; do	doing more is what they want
those enterprises however are not going to be privatized ; privatized	privatization is what those enterprises however are not going to be doing
afterwards i went home and practiced for three hours ; practiced	practicing for three hours was what i did when i went home afterwards
i would n't expect an immediate resolution to anything ; expect	the expecting of an immediate resolution to anything is not something i would do
mr. kageyama is accurate to deny a specific anti-american bias ; deny	denying a specific anti-american bias is what mr. kageyama is accurate to do
nissan will introduce a completely revamped sentra next fall ; introduce	introduction of a completely revamped sentra next fall will be done by nissan
spending by japanese households averaged 290,782 yen 2,052.10 in august ; averaged	averaging 290,782 yen 2,052.10 in august was spending by japanese households
revenue rose slightly to 3.8 billion from 3.7 billion ; rose	rising slightly to 3.8 billion from 3.7 billion was revenue
the apparel maker would n't disclose terms of the agreement ; disclose	disclosure of terms of the agreement is something the apparel maker would not do
cbs sports earned 50 million or so last year ; earned	earning 50 million or so last year was cbs sports
cincinnati bell inc. said net declined 1.8 % ; said	saying that net declined 1.8 % was cincinnati bell inc
a decision is n't expected until some time next year ; expected	the expecting of the decision will not occur until some time next year
says mr. steidtmann i 'm looking for a bi-polar christmas ; says	saying i 'm looking for a bi-polar christmas was what mr. steidtmann did
put these together and you get programs about rape ; get	getting programs about rape is what happens when you put these together
sales rose 11 % to 7.73 billion from 6.94 billion ; rose	the rising of sales was 11 percent from 6.94 billion to 7.73 billion
previously the company advertised at the 2 million level ; advertised	advertising at the 2 million level is what the company previously did
mr. bass is based in fort worth ; based	basing in fort worth is what mr bass does
nashua announced the reiss request after the market closed ; closed	the closing of the market was when nashua announced the reiss request
in another sign of slowdown fears investors dumped technology shares ; dumped	dumping technology shares is what investors did in another sign of slowdown fears
when it went down by all tradition the economy followed ; followed	the following of the economy was when it went down by all tradition
mr. ahmad 's lawyer said he would appeal ; said	the statement that he would appeal came from mr. ahmad's lawyer
the dollar rose against the swiss and french francs ; rose	rising against the swiss and french francs was the dollar
the economy is showing signs of weakness particularly among manufacturers ; showing	a show of signs of weakness is what the economy is doing particularly among manufacturers
white children empty the wastepaper baskets and squeegee the windows ; squeegee	squeegeeing of the windows is done by white children who empty the wastepaper baskets
the work was done properly he said ; done	the doing of the work was proper he said
the december contract declined 1.85 cents a pound to 1.2645 ; declined	declining 1.85 cents a pound to 1.2645 was what the december contract did
mr. baker promises to return if the haunting continues ; promises	promising to return if the haunting continues was mr baker
dr. lourie says the justice department interviewed him last july ; interviewed	the interviewing of dr lourie was by the justice department last july
cathay officials decline to comment on the speculation ; decline	declining to comment on the speculation is what cathay officials did
both took further hits yesterday ; took	taking further hits yesterday were both of them
proceeds from those sales will be used to reduce debt ; used	using proceeds from those sales to reduce debt is what will be done
many economists expect the weakness to continue ; expect	the expecting of the weakness to continue is felt by many economists
i think you have to give greenspan a good rating ; give	giving greenspan a good rating is something i think you have to do
the fundamentals are pretty strong mr. dreman says ; says	saying the fundamentals are pretty strong is mr dreman
sir richard succeeds john plastow who resigned in july ; resigned	resigning in july was john plastow who sir richard succeeds
a side porch was ripped away ; ripped	ripping away is what happened to a side porch
the issue will be sold through morgan stanley & co ; sold	selling through morgan stanley & co is what will be done with the issue
revenue rose 6.4 % to 415.3 million from 390.5 million ; rose	rising 6.4 % to 415.3 million from 390.5 million was revenue
his election increases ryder 's board to 14 members ; increases	increasing ryder 's board to 14 members is what his election does
you do n't know which way to punch ; know	the knowing of which way to punch isn't known
mr. barre 's rule is crumbling fast ; crumbling	crumbling fast is what mr. barre 's rule is doing
the sales pitch could n't sound better ; sound	the sounding of the sales pitch could not have been better
polymerix makes lumber-like materials that it describes as plastic wood ; describes	the describing of it as plastic wood is done by polymerix who makes lumber like materials
veiling his message has helped him endure ; helped	helping him endure is what veiling his message has done
mr. baker promises to return if the haunting continues ; continues	the continuation of the haunting will cause mr baker to return he promises
when stocks stabilized that was a disappointment ; stabilized	the stabilizing of stocks was a disappointment
qintex 's 1.5 billion pact to buy mgm\/ua collapsed recently ; buy	the buying of mgmvua by qintex through a 1.5 billion pact collapsed recently
mr. bush returned to washington saturday night ; returned	returning to washington saturday night was what mr bush did
the second factor spurring mega-issues is political ; spurring	the spurring of mega issues from the second factor is political
it 's like fighting your way out of a fog ; fighting	fighting your way out of a fog is what it is like
the last taxpayer compliance measurement program survey covered 1985 returns ; covered	the covering of 1985 returns was done through the last taxpayer compliance measurement program survey
analysts predict little or no near-term growth ; predict	prediction of little or no near-term growth was given by analysts
the unions and the company last week agreed to mediation ; agreed	agreeing to mediation is what the unions and the company did last week
the offer expired at 12:01 a.m. yesterday ; expired	expiring at 12:01 am yesterday is what the offer did
that 'll save us time and get people involved ; save	saving us time and getting people involved is what that will do
mr. locke teaches english and comparative literature at columbia university ; teaches	teaching english and comparative literature at columbia university is what mr locke does
what that will mean for manufacturers is anybody 's guess ; mean	the meaning that will have for manufacturers is anybody 's guess
by starving the peasant the communists have starved poland ; starved	starving poland is what the communists have done by starving the peasant
california thefts make travel agents jittery ; make	making travel agents jittery is what california thefts do
any fool can publish a money-losing magazine ; publish	publishing a money-losing magazine is something any fool can do
other furriers have also benefited from leathers ; benefited	benefiting from leathers is what other furriers have also done
omni capital group surged 1 3\/4 to 16 1\/4 ; surged	the surge of omni capital group was 1 3\/4 to 16 1\/4
those enterprises however are not going to be privatized ; going	the going of those enterprises is not to be privatized
they showed up but did n't or could n't challenge ; showed	showing up is what they did but they did n't or could n't challenge
otherwise actual profit is compared with the 300-day estimate ; compared	comparison with the 300-day estimate is otherwise done with actual profit
but mexico urgently needs more help ; needs	but needing more help urgently is mexico
one big technology issue novell rode the roller coaster ; rode	the riding of the roller coaster by novell was one big technology issue
other companies figure they ca n't avoid the market ; figure	figuring they ca n't avoid the market is what other companies do
the companion tax-exempt funds add 71 billion ; add	adding 71 billion is what the companion tax-exempt funds do
other temperature data show similar unexplained swings ; show	showing similar unexplained swings is what other temperature data do
they 're not there to work out ; work	working out is not what they are there to do
by starving the peasant the communists have starved poland ; starving	the starving of the peasant has caused the communists to also starved poland
general dynamics closed at 54.875 up 50 cents ; closed	closing at 54.875 up 50 cents is what general dynamics did
the issue has been simmering for years ; simmering	simmering for years is what the issue has been doing
we wanted them to build a road here he says ; wanted	the wanting of them to build a road is here he says
but the new jersey u.s. attorney averaged 16 ; averaged	the averaging of 16 was done by the new jersey us attorney
however operating profit fell 35 % to 16.4 million ; fell	the fall of operating profit however was 35% to 16.4 million
that 'll save us time and get people involved ; involved	involving people and saving time is what that will get us
but steelmakers must also find new markets ; find	but finding new markets is what steelmakers must also do
nor is cbs a shoo-in to get blockbuster ratings ; get	the getting of blockbuster ratings is not a shoo in for cbs
the real tragedies occurred elsewhere as we soon found out ; found	the finding out of the real tragedies that occurred elsewhere happened soon
ms. bartlett would not discuss her garden for this article ; discuss	discussing her garden for this article is something ms bartlett would not do
anne does n't believe in blandness said ms. smith ; said	saying that anne does n't believe in blandness was what ms smith did
new trade accords were signed ; signed	signing of new trade accords was done
per-share net rose to 47.46 yen from 39.31 yen ; rose	the rise of the per-share net was from 39.31 yen to 47.46 yen
call it the we 're too broke to fight defense ; call	the calling of it is the were too broke to fight defense fund
and he yelled out dolce dolce sweet sweet ; yelled	and yelling out dolce dolce sweet sweet is what he did
it would n't discuss a price ; discuss	discussing a price is what it would not do
they can be 1 billion plus mr. richardson said ; said	saying they can be 1 billion plus is what mr. richardson did
jewelry makers copy cosmetics sales ploys ; copy	copying cosmetics sales ploys is what jewelry makers are doing
as wall street strengthened the london trading room went wild ; went	the going wild of the london trading room was due to the strengthening of wall street
airborne freight climbed 1 1\/8 to 38 1\/2 ; climbed	climbing 1 1\/8 to 38 1\/2 was airborne freight
i just do n't understand it ; understand	understanding it is what i just do not do
with that authority of course goes an unambiguous accountability ; goes	going with that authority of course is an unambiguous accountability
in either case the investor faces three possible outcomes ; faces	facing three possible outcomes in either case is what investors are doing
stateswest asked mesa to repond by oct. 31 ; repond	a response by oct. 31 was what stateswest asked mesa to provide
jackets may be sold next ; sold	selling next may be jackets
for them it makes all kinds of sense ; makes	making all kinds of sense is what it does for them
par said it is cooperating in the investigation ; said	saying that it is cooperating in the investigation is what par did
house speaker foley ought to deliver that promise ; deliver	the delivering of that promise should be by house speaker foley
they always listened but they never acted mr. guber says ; acted	acting was something they never did but they always listened mr. guber says
and if the europeans come in they benefit too ; come	the coming in by the europeans could be of benefit to them too
i 've surrendered to the circumstances mr. fedders says ; surrendered	surrendering to the circumstances is what i've done mr. fedders says
sales of parts for cars and construction vehicles rose ; rose	rising were sales of parts for cars and construction vehicles
the current quarter he said looks fine ; looks	looking fine is what the current quarter does he said
dpc holds about 7.8 % of dataproducts ' shares ; holds	the holding of dataproducts shares by the dpc is about 7.8 percent
dr. lourie says the justice department interviewed him last july ; says	saying that the justice department interviewed him last july is what dr lourie does
we certainly see an increasing trend toward that she added ; increasing	the increasing of the trend towards that is something we certainly see she added
their opposition helped scare off some japanese banks ; helped	helping to scare off some japanese banks is what their opposition did
kidder peabody & co. is trying to struggle back ; trying	trying to struggle back was kidder peabody & co
wall street is n't avoiding everything connected with paper ; avoiding	the avoiding of everything connected with paper is not something wall street is doing
consider adopting your spouse 's name ; consider	the considering of what to adopt is your spouses name
when it went down by all tradition the economy followed ; went	the going down of it was by all tradition and the economy followed
there 's no finger to be pointed she said ; said	saying there 's no finger to be pointed is what she did
plant lovers who studied the maquette were alarmed ; studied	the studying of the maquette alarmed plant lovers
the gene thus can prevent a plant from fertilizing itself ; fertilizing	fertilizing itself is what the gene can thus prevent a plant from doing
they 're getting some major wins she added ; added	adding they 're getting some major wins is what she did
they effectively lead team efforts to reduce cycle time ; lead	the leading of team efforts to reduce cycle time was done effectively by them
the phillips plant makes polyethylene polypropylene and other plastic products ; makes	the making of polyethylene polypropylene and other plastic products is done by the phillips plant
he would agrees the chairman ; agrees	agreeing that he would was the chairman
a spokesman cited a technical error and declined to elaborate ; declined	the declining of the elaboration by the spokesman cited a technical error only
the media she says have distorted his personal life ; says	saying the media have distorted his personal life is what she does
but many predicted that the commercial disruption would be short-lived ; predicted	but predicting that the commercial disruption would be short-lived is what many did
an earthquake struck northern california killing more than 50 people ; killing	killing more than 50 people is what an earthquake that struck northern california did
a guinness spokesman declined to comment ; declined	declining to comment was a guinness spokesman
mr. bates usually handles day-to-day ual trading on his own ; handles	handling day-to-day ual trading on his own is what mr bates usually does
sales rose to 2.45 billion from 2.2 billion ; rose	the rising of sales was from 2.2 billion to 2.45 billion
some high-priced issues made a comeback friday ; made	making a comeback friday were some high priced issues
some companies including heinz even pay part of the fee ; including	inclusion in some companies that even pay part of the fee is heinz
sales fell 1.5 % to 884 million from 897.2 million ; fell	falling 1.5 % to 884 million from 897.2 million were sales
i refer essentially to petroleum electric power banking and newsprint ; refer	referring essentially to petroleum electric power banking and newsprint is what i do
says mr. steidtmann i 'm looking for a bi-polar christmas ; looking	the looking of a bi polar christmas is being done by mr steidtmann
it all adds up to a cold winter here ; adds	adding up to a cold winter here is what it all does
yet his political setbacks mounted ; mounted	mounting was yet was his political setbacks did
today there are 77 units all located in shopping malls ; located	the locating today of 77 units are all located in shopping malls
the current quarter he said looks fine ; said	the saying that he thinks it looks fine is in regards to the current quarter
unless the questions are answered i will keep on going ; answered	the answering of questions will keep me from going on
not everybody was making money ; making	making money is something not everybody was doing
also the big board met with angry stock specialists ; met	meeting with angry stock specialists is what the big board also did
kidder peabody & co. is trying to struggle back ; struggle	struggling back is what kidder peabody & co. is trying to do
but trelleborg still must clear some tough hurdles ; clear	the clearing of some tough hurdles much still be done by trelleborg
but observers expect broad support ; expect	the expecting of broad support comes from observers
nekoosa also is being advised by goldman sachs & co ; advised	advising by goldman sachs & co is also being done for nekoosa
however for many managing speed does not come naturally ; managing	managing of speed does not come naturally for many however
here are two cases to illustrate ; illustrate	illustrating it are two cases here
stateswest asked mesa to repond by oct. 31 ; asked	asking mesa to respond by oct 31 is what stateswest did
coors with its large beer-distribution network could penetrate more markets ; penetrate	the penetrating of markets could be by coors with its large beer distribution network
this market has been very badly damaged ; damaged	the damaging of the market has been very badly
this conclusion he said restored the credibility of tokyo stocks ; restored	the restoring of the credibility of tokyo stocks he said came from this conclusion
but some analysts wonder how strong the recovery will be ; wonder	but wondering how strong the recovery will be are some analysts
the panhandler approaches makes his pitch ; makes	making his pitch is the panhandler as he approaches
some current rates exceed those on cds ; exceed	the exceeding of some current rates is over those on cds
the government built ports bridges highways schools hospitals and railways ; built	building of ports bridges highways schools hospitals and railways is what the government did
they were absolutely killed slaughtered said one chicago-based options trader ; killed	the killing they suffered was absolute, said one chicago-based options trader.
the fundamentals do n't change in an hour he says ; says	saying the fundamentals do n't change in an hour is what he does
the report is to be released today ; released	releasing today is what will be done to the report
estimated volume was three million ounces ; estimated	the estimating of three million ounces was for the volume
and there he was recalls mr. engelken ; recalls	recalling and there he was is what mr. engelken does
the devices ' most remarkable possibilities though involve the brain ; involve	involvement of the brain is found in the devices' most remarkable possibilities though
the country was renamed the republic of hungary ; renamed	the renaming of the country was to the republic of hungary
names are resigning at an even faster pace this year ; resigning	the resigning of names are at an even faster pace this year
they serve the industries and the special-interest groups ; serve	the serving of industries and special interest groups is done by them
revenue rose 5 % to 110.4 million from 105.4 million ; rose	rising 5 % to 110.4 million from 105.4 million was revenue
milton roy jumped 2 to 18 3\/8 ; jumped	the jump of milton roy was 2 to 18 3\/8
in major market activity stock prices rose in light trading ; rose	rising in light trading is what stock prices did in major market activity
estimated and actual results involving losses are omitted ; involving	the involving of losses are omitted in terms of estimated and actual results
the london times said she had contravened protocol ; said	the saying that she had contravened protocol came from the london times
eventually mr. postel broke his toe in the dark ; broke	breaking his toe in the dark is eventually what mr postel did
proceeds will be used to eliminate and restructure bank debt ; used	the using of the proceeds will be to eliminate and restructure bank debt
its 1.7 million-share offering was priced at 15 ; priced	pricing of its 1.7 million-share offering was at 15
this news raised hopes for further interest-rate cuts ; raised	the raising of hopes for further interest rate cuts was brought up by the news
he confers big trading commissions on wall street firms ; confers	conferring big trading commissions on wall street firms is what he does
those who bought that illusion are now bewildered ; bought	buying that allusion left those who did now bewildered
i still say do n't look down ; look	looking down is what i still say do not do
mr. evans could n't be reached yesterday for comment ; reached	reaching mr evans yesterday for comment could not be done
the excess supply pushed gasoline prices down in that period ; pushed	pushing gasoline prices down in that period is what the excess supply did
as wall street strengthened the london trading room went wild ; strengthened	the strengthening of wall street caused the london trading room to go wild
a reflects 2-for-1 stock split effective dec. 30 1988 ; reflects	the reflecting for a 2 for 1 stock split is effective dec 30 1988
the markets are returning to normalcy ; returning	returning to normalcy is what the markets are doing
sales were 4.2 billion compared with 3.7 billion ; compared	the comparison of sales was 4.2 billion with 3.7 billion
it flopped all around real dramatic ; flopped	flopping all around real dramatic is what it did
the firm was indicted in tampa fla. on money-laundering charges ; indicted	the indicting of the firm in tampa fla was on money laundering charges
qintex 's 1.5 billion pact to buy mgm\/ua collapsed recently ; collapsed	the collapsing of qintexs 1.5 billion pact to buy mgmvua was recent
those who bought that illusion are now bewildered ; bewildered	the bewildering of those that bought the illusion is happening now
these errata do not affect business programs he said ; affect	affecting business programs is not what these errata do he said
federal prosecutors are concluding fewer criminal cases with trials ; concluding	the conclusion of fewer criminal cases with trials is what federal prosecutors are doing
her share decreases but only slightly ; decreases	the decreasing of her share has only been slightly
this may sound strangely optimistic ; sound	the sounding of this may be strangely optimistic
the group consists of weslock corp. and jpi modern inc ; consists	consisting of weslock corp and jpi modern inc is the group
now those routes are n't expected to begin until jan ; begin	beginning until jan is now what those routes are n't expected to do
northview officials could n't be located ; located	location of northview officials could n't be done
both philip morris and backer spielvogel declined to comment ; comment	commenting is what both philip morris and backer spielvogel declined to do
but pfizer inc. based in new york reported flat earnings ; based	the basing in new york is pfizer inc who reported flat earnings
par said it is cooperating in the investigation ; cooperating	cooperating in the investigation is what par said it is doing
himont quantum and union carbide all declined to comment ; declined	the declining of any comment came from himont quantum and union carbide
if you 're a technician you obey the signals ; obey	the obeying of the signals is what you do if you're a technician
norfolk southern went up 1 1\/8 to 37 7\/8 ; went	going up 1 1\/8 to 37 7\/8 was what norfolk southern did
mr. sukle says he would n't dream of participating himself ; dream	dreaming of participating himself is what mr. sukle says he would not do
meanwhile the treasury sold 9.75 billion of 52-week bills yesterday ; sold	selling 9.75 billion of 52-week bills yesterday is what the treasury did meanwhile
a guinness spokesman declined to comment ; comment	commenting is what a guinness spokesman declined to do
but it has n't increased much relative to other assets ; increased	the increasing of it has not been relative much to other assets
the merksamer bankruptcy-law filing appears to supersede that agreement ; appears	the appearance of superseding that agreement is caused by the merksamer bankruptcy-law filing
what could imply more safety than investing in government bonds ; imply	the implying of more safety is in investing in government bonds
i could n't afford to hire 16 whites ; afford	affording to hire 16 whites is what i could not do
millions of refugees would rush home ; rush	the rush home would be done by millions of refugees
he now calls himself an investment banker ; calls	the calling of himself an investment banker he something he does now
revenue rose 25 % to 877.6 million from 702.4 million ; rose	rising 25 % to 877.6 million from 702.4 million was revenue
it adds something to the market ; adds	the adding of it to the market is something
it was the opposite of what happened on oct. 19 ; happened	the happening of it was the opposite of what occurred on oct 19
in new york the company declined comment ; declined	the declining of the comment came from the new york company
it 's hard to know if people are responding truthfully ; know	knowing if people are responding truthfully is what is hard to do
the merksamer bankruptcy-law filing appears to supersede that agreement ; supersede	superseding that agreement was what the merksamer bankruptcy-law filing appears to do
ortega had threatened to end a 19-month-old ceasefire ; threatened	threaten to end a 19-month-old ceasefire is what ortega had done
both reflect the dismissal of lower-level and shorter-tenure executives ; reflect	reflecting the dismissal of lower-level and shorter-tenure executives are both of them
his humility gives him a much better chance of success ; gives	the giving of a much better chance of success to him comes from his humility
and if the europeans come in they benefit too ; benefit	the benefiting of europeans could occur of they come too
they were absolutely killed slaughtered said one chicago-based options trader ; slaughtered	the slaughtering and killing of them absolutely happened said one chicago-based options trader
the times are my times says mr. florio ; says	saying that the times are my times is what mr. florio does
but ms. mccraw says the magazine is fighting back ; fighting	the fighting back comes from the magazine ms mccraw claims
mr. allday would succeed martha hesse who is resigning ; resigning	resigning is being done by martha heese who would be succeeded by mr. allday
we are a vanishing breed he muses ; vanishing	a vanishing breed is what we are he muses
this conclusion he said restored the credibility of tokyo stocks ; said	saying this conclusion restored the credibility of tokyo stocks is what he did
chrysler corp. also hit the rocks in mid-october ; hit	hitting the rocks in mid-october was also chrysler corp
the service did n't identify its tokyu sources ; identify	the identifying of its tokyo sources did not occur by the service
i find it very difficult to say that ; say	the saying of that i find very difficult
shortage and crisis became buzz words although neither really applied ; became	becoming buzz words although neither really applied were shortage and crisis
now those routes are n't expected to begin until jan ; expected	the expecting of those routes isnt to begin until jan
that followed a 3.3 % decline in august ; followed	following a 3.3 % decline in august was what that did
revenue soared to 117 million from 81.5 million ; soared	soaring to 117 million from 81.5 million was revenue
manufacturers too are stretching further to lure buyers ; stretching	stretching further to lure buyers is what manufacturers too are doing
the price was n't disclosed ; disclosed	the disclosing of the price did not occur
terms of the agreement were n't given ; given	giving of the terms of the agreement was not done
and prosecutors declined to comment ; declined	and declining to comment were the prosecutors
